################
#@ # # #    #  #
#    # #    #  #
#  #   #    #  #
#  # # #    #  #
#  # # #       #
#  # # #    #  #
#  # # #    # ##
#  # #      #  #
#  # # #    #  #
#  # # #    #  #
#### ###########
#              #
############## #
#              #
################