################
#@#            #
# #    ###### ##
# #    #  #    #
#      #       #
# #    #  #    #
# #    #  #    #
# #    #  #    #
# ### ##  #    #
# #    #  #    #
# ## ###  #    #
# #    #  #    #
# #    #### ####
# #### #       #
# #    #       #
################