################
#@             #
############# ##
#      #  # #  #
#      #  #    #
### ####    #  #
#      #  # #  #
#      #  # #  #
#      #  # #  #
#         # #  #
#      #  # #  #
## #####  # #  #
#      #  # #  #
###### #  # #  #
#      #  # #  #
################