################
#@             #
# ##############
#              #
#              #
#              #
######### ######
#              #
#              #
## #############
#              #
####### ########
#              #
######## #######
#              #
################