################
#@          #  #
####### #####  #
#           #  #
###### ######  #
#       #   #  #
#       #   #  #
#       #   #  #
#       #   #  #
#       #   #  #
#           #  #
#       #   #  #
# ###########  #
#              #
#           #  #
################