   #                    #                    #                                                              #                                         #   
   #                    #                    #                                                              #                                         #   
   #                    #                    #                                                              #                                         #   
##########################################################################################################################################################
   #                    #                    #                                                              #                                         #   
   #                    #                    #                                                              #                                         #   
   #                    #                    #                                                              #                                         #   
   #                    #                    #                                                              #                                         #   
   #                    #                    #                                                              #                                         #   
   #                    #                    #                                                              #                                         #   
   #      @             #                    #                                                              #                                         #   
   #                    #                    #                                                              #                                         #   
   #                    #                    #                                                              #                                         #   
   #                    #                    #                                                              #                                         #   
   #                                                              #                    #                                         #                    #   
   #                                                              #                    #                                         #                    #   
   #                                                              #                    #                                         #                    #   
   #                                                              #                    #                                         #                    #   
   #                                                              #                    #                                         #                    #   
   #                                                              #                    #                                         #                    #   
   #                                                              #                    #                                         #                    #   
   #                    #                    #                    #                    #                    #                    #                    #   
   #                    #                    #                    #                    #                    #                    #                    #   
   #                    #                    #                    #                    #                    #                    #                    #   
########################################################       ############################       ##############       ###################################
   #                    #                    #                    #                    #                    #                    #                    #   
   #                    #                    #                    #                    #                    #                    #                    #   
   #                    #                    #                    #                    #                    #                    #                    #   
   #                    #                    #                    #                    #                    #                    #                    #   
   #                    #                    #                    #                    #                    #                    #                    #   
   #                    #                    #                    #                    #                    #                    #                    #   
   #                    #                    #                    #                    #                    #                    #                    #   
   #                    #                    #                    #                    #                    #                    #                    #   
   #                    #                    #                    #                    #                    #                    #                    #   
   #                    #                    #                    #                    #                    #                    #                    #   
   #                                                                                   #                    #                                         #   
   #                                                                                   #                    #                                         #   
   #                                                                                   #                    #                                         #   
   #                                                                                   #                    #                                         #   
   #                                                                                   #                    #                                         #   
   #                                                                                   #                    #                                         #   
   #                                                                                   #                    #                                         #   
   #                                                              #                    #                    #                    #                    #   
   #                                                              #                    #                    #                    #                    #   
   #                                                              #                    #                    #                    #                    #   
#################################################       ###################################       ########################################################
   #                                                              #                    #                    #                    #                    #   
   #                                                              #                    #                    #                    #                    #   
   #                                                              #                    #                    #                    #                    #   
   #                                                              #                                                              #                    #   
   #                                                              #                                                              #                    #   
   #                                                              #                                                              #                    #   
   #                                                              #                                                              #                    #   
   #                                                              #                                                              #                    #   
   #                                                              #                                                              #                    #   
   #                                                              #                                                              #                    #   
   #                    #                    #                    #                    #                    #                                         #   
   #                    #                    #                    #                    #                    #                                         #   
   #                    #                    #                    #                    #                    #                                         #   
   #                    #                    #                    #                    #                    #                                         #   
   #                    #                    #                    #                    #                    #                                         #   
   #                    #                    #                    #                    #                    #                                         #   
   #                    #                    #                    #                    #                    #                                         #   
   #                    #                    #                    #                    #                    #                    #                    #   
   #                    #                    #                    #                    #                    #                    #                    #   
   #                    #                    #                    #                    #                    #                    #                    #   
##############          #          #####################       ############################       #####################       ############################
   #                    #                    #                    #                    #                    #                    #                    #   
   #                    #                    #                    #                    #                    #                    #                    #   
   #                    #                    #                    #                    #                    #                    #                    #   
   #                    #                    #                    #                    #                    #                    #                    #   
   #                    #                    #                    #                    #                    #                    #                    #   
   #                    #                    #                    #                    #                    #                    #                    #   
   #                    #                    #                    #                    #                    #                    #                    #   
   #                    #                    #                    #                    #                    #                    #                    #   
   #                    #                    #                    #                    #                    #                    #                    #   
   #                    #                    #                    #                    #                    #                    #                    #   
   #                    #                    #                    #                                         #                    #                    #   
   #                    #                    #                    #                                         #                    #                    #   
   #                    #                    #                    #                                         #                    #                    #   
   #                    #                    #                    #                                         #                    #                    #   
   #                    #                    #                    #                                         #                    #                    #   
   #                    #                    #                    #                                         #                    #                    #   
   #                    #                    #                    #                                         #                    #                    #   
   #                    #                    #                    #                    #                    #                    #                    #   
   #                    #                    #                    #                    #                    #                    #                    #   
   #                    #                    #                    #                    #                    #                    #                    #   
###################################       ###################################       ##############          #          #####################          #   
   #                    #                    #                    #                    #                    #                    #                    #   
   #                    #                    #                    #                    #                    #                    #                    #   
   #                    #                    #                    #                    #                    #                    #                    #   
   #                    #                                         #                    #                    #                                         #   
   #                    #                                         #                    #                    #                                         #   
   #                    #                                         #                    #                    #                                         #   
   #                    #                                         #                    #                    #                                         #   
   #                    #                                         #                    #                    #                                         #   
   #                    #                                         #                    #                    #                                         #   
   #                    #                                         #                    #                    #                                         #   
   #                                         #                    #                    #                    #                    #                    #   
   #                                         #                    #                    #                    #                    #                    #   
   #                                         #                    #                    #                    #                    #                    #   
   #                                         #                    #                    #                    #                    #                    #   
   #                                         #                    #                    #                    #                    #                    #   
   #                                         #                    #                    #                    #                    #                    #   
   #                                         #                    #                    #                    #                    #                    #   
   #                    #                    #                    #                    #                    #                    #                    #   
   #                    #                    #                    #                    #                    #                    #                    #   
   #                    #                    #                    #                    #                    #                    #                    #   
############################       ##########################################       ######################################################################
   #                    #                    #                    #                    #                    #                    #                    #   
   #                    #                    #                    #                    #                    #                    #                    #   
   #                    #                    #                    #                    #                    #                    #                    #   
   #                    #                                         #                                                              #                    #   
   #                    #                                         #                                                              #                    #   
   #                    #                                         #                                                              #                    #   
   #                    #                                         #                                                              #                    #   
   #                    #                                         #                                                              #                    #   
   #                    #                                         #                                                              #                    #   
   #                    #                                         #                                                              #                    #   
   #                                         #                    #                    #                    #                    #                    #   
   #                                         #                    #                    #                    #                    #                    #   
   #                                         #                    #                    #                    #                    #                    #   
   #                                         #                    #                    #                    #                    #                    #   
   #                                         #                    #                    #                    #                    #                    #   
   #                                         #                    #                    #                    #                    #                    #   
   #                                         #                    #                    #                    #                    #                    #   
   #                    #                    #                    #                    #                    #                    #                    #   
   #                    #                    #                    #                    #                    #                    #                    #   
   #                    #                    #                    #                    #                    #                    #                    #   
##############       ##############       ###################################       #################################################       ##############
   #                    #                    #                    #                    #                    #                    #                    #   
   #                    #                    #                    #                    #                    #                    #                    #   
   #                    #                    #                    #                    #                    #                    #                    #   
   #                    #                    #                    #                    #                    #                    #                    #   
   #                    #                    #                    #                    #                    #                    #                    #   
   #                    #                    #                    #                    #                    #                    #                    #   
   #                    #                    #                    #                    #                    #                    #                    #   
   #                    #                    #                    #                    #                    #                    #                    #   
   #                    #                    #                    #                    #                    #                    #                    #   
   #                    #                    #                    #                    #                    #                    #                    #   
   #                    #                    #                                                                                                        #   
   #                    #                    #                                                                                                        #   
   #                    #                    #                                                                                                        #   
   #                    #                    #                                                                                                        #   
   #                    #                    #                                                                                                        #   
   #                    #                    #                                                                                                        #   
   #                    #                    #                                                                                                        #   
   #                    #                    #                                                                                                        #   
   #                    #                    #                                                                                                        #   
   #                    #                    #                                                                                                        #   
##########################################################################################################################################################
   #                    #                    #                                                                                                        #   
   #                    #                    #                                                                                                        #   
   #                    #                    #                                                                                                        #   