################
#@      #    # #
#       #    # #
#       #      #
#            # #
#       #    # #
#       #    # #
# #######    # #
#       #### ###
#       #      #
##### ### ######
#       #      #
# ##############
#              #
#              #
################