################
#@             #
#              #
### ############
#              #
#### ###########
# #    # # # # #
# #    #   # # #
#      # # # # #
# #      # #   #
# #    # #   # #
# #    # # # # #
# #    # # # # #
# #    # # # # #
# #    # # # # #
################