################
#@             #
####### ########
#       #      #
#            # #
#       #    # #
########### ####
#              #
######### ######
#              #
############## #
#              #
#              #
######### ######
#              #
################