   #                                         #                                                              #                                         #   
   #                                         #                                                              #                                         #   
   #                                         #                                                              #                                         #   
##########################################################################################################################################################
   #                                         #                                                              #                                         #   
   #                                         #                                                              #                                         #   
   #                                         #                                                              #                                         #   
   #                                         #                                                              #                                         #   
   #                                         #                                                              #                                         #   
   #                                         #                                                              #                                         #   
   #      @                                  #                                                              #                                         #   
   #                                         #                                                              #                                         #   
   #                                         #                                                              #                                         #   
   #                                         #                                                              #                                         #   
   #                    #                                         #                    #                                         #                    #   
   #                    #                                         #                    #                                         #                    #   
   #                    #                                         #                    #                                         #                    #   
   #                    #                                         #                    #                                         #                    #   
   #                    #                                         #                    #                                         #                    #   
   #                    #                                         #                    #                                         #                    #   
   #                    #                                         #                    #                                         #                    #   
   #                    #                    #                    #                    #                                         #                    #   
   #                    #                    #                    #                    #                                         #                    #   
   #                    #                    #                    #                    #                                         #                    #   
   #          ##########################################       ############################       ###################################       ##############
   #                    #                    #                    #                    #                                         #                    #   
   #                    #                    #                    #                    #                                         #                    #   
   #                    #                    #                    #                    #                                         #                    #   
   #                                         #                    #                                                              #                    #   
   #                                         #                    #                                                              #                    #   
   #                                         #                    #                                                              #                    #   
   #                                         #                    #                                                              #                    #   
   #                                         #                    #                                                              #                    #   
   #                                         #                    #                                                              #                    #   
   #                                         #                    #                                                              #                    #   
   #                    #                    #                    #                    #                    #                    #                    #   
   #                    #                    #                    #                    #                    #                    #                    #   
   #                    #                    #                    #                    #                    #                    #                    #   
   #                    #                    #                    #                    #                    #                    #                    #   
   #                    #                    #                    #                    #                    #                    #                    #   
   #                    #                    #                    #                    #                    #                    #                    #   
   #                    #                    #                    #                    #                    #                    #                    #   
   #                    #                    #                    #                    #                    #                    #                    #   
   #                    #                    #                    #                    #                    #                    #                    #   
   #                    #                    #                    #                    #                    #                    #                    #   
   #          ##############       ##############       ##########################################       #################################################
   #                    #                    #                    #                    #                    #                    #                    #   
   #                    #                    #                    #                    #                    #                    #                    #   
   #                    #                    #                    #                    #                    #                    #                    #   
   #                    #                    #                                         #                    #                    #                    #   
   #                    #                    #                                         #                    #                    #                    #   
   #                    #                    #                                         #                    #                    #                    #   
   #                    #                    #                                         #                    #                    #                    #   
   #                    #                    #                                         #                    #                    #                    #   
   #                    #                    #                                         #                    #                    #                    #   
   #                    #                    #                                         #                    #                    #                    #   
   #                    #                    #                    #                    #                                         #                    #   
   #                    #                    #                    #                    #                                         #                    #   
   #                    #                    #                    #                    #                                         #                    #   
   #                    #                    #                    #                    #                                         #                    #   
   #                    #                    #                    #                    #                                         #                    #   
   #                    #                    #                    #                    #                                         #                    #   
   #                    #                    #                    #                    #                                         #                    #   
   #                    #                    #                    #                    #                    #                    #                    #   
   #                    #                    #                    #                    #                    #                    #                    #   
   #                    #                    #                    #                    #                    #                    #                    #   
##############       ###################################       ######################################################################       ##############
   #                    #                    #                    #                    #                    #                    #                    #   
   #                    #                    #                    #                    #                    #                    #                    #   
   #                    #                    #                    #                    #                    #                    #                    #   
   #                                         #                                         #                    #                                         #   
   #                                         #                                         #                    #                                         #   
   #                                         #                                         #                    #                                         #   
   #                                         #                                         #                    #                                         #   
   #                                         #                                         #                    #                                         #   
   #                                         #                                         #                    #                                         #   
   #                                         #                                         #                    #                                         #   
   #                    #                    #                    #                                         #                    #                    #   
   #                    #                    #                    #                                         #                    #                    #   
   #                    #                    #                    #                                         #                    #                    #   
   #                    #                    #                    #                                         #                    #                    #   
   #                    #                    #                    #                                         #                    #                    #   
   #                    #                    #                    #                                         #                    #                    #   
   #                    #                    #                    #                                         #                    #                    #   
   #                    #                    #                    #                                         #                    #                    #   
   #                    #                    #                    #                                         #                    #                    #   
   #                    #                    #                    #                                         #                    #                    #   
##############       ########################################################       ############################       ###################################
   #                    #                    #                    #                                         #                    #                    #   
   #                    #                    #                    #                                         #                    #                    #   
   #                    #                    #                    #                                         #                    #                    #   
   #                    #                    #                                                                                                        #   
   #                    #                    #                                                                                                        #   
   #                    #                    #                                                                                                        #   
   #                    #                    #                                                                                                        #   
   #                    #                    #                                                                                                        #   
   #                    #                    #                                                                                                        #   
   #                    #                    #                                                                                                        #   
   #                                         #                    #                    #                    #                    #                    #   
   #                                         #                    #                    #                    #                    #                    #   
   #                                         #                    #                    #                    #                    #                    #   
   #                                         #                    #                    #                    #                    #                    #   
   #                                         #                    #                    #                    #                    #                    #   
   #                                         #                    #                    #                    #                    #                    #   
   #                                         #                    #                    #                    #                    #                    #   
   #                    #                    #                    #                    #                    #                    #                    #   
   #                    #                    #                    #                    #                    #                    #                    #   
   #                    #                    #                    #                    #                    #                    #                    #   
###################################       ########################################################       #################################################
   #                    #                    #                    #                    #                    #                    #                    #   
   #                    #                    #                    #                    #                    #                    #                    #   
   #                    #                    #                    #                    #                    #                    #                    #   
   #                    #                    #                    #                    #                                                              #   
   #                    #                    #                    #                    #                                                              #   
   #                    #                    #                    #                    #                                                              #   
   #                    #                    #                    #                    #                                                              #   
   #                    #                    #                    #                    #                                                              #   
   #                    #                    #                    #                    #                                                              #   
   #                    #                    #                    #                    #                                                              #   
   #                    #                                                              #                    #                    #                    #   
   #                    #                                                              #                    #                    #                    #   
   #                    #                                                              #                    #                    #                    #   
   #                    #                                                              #                    #                    #                    #   
   #                    #                                                              #                    #                    #                    #   
   #                    #                                                              #                    #                    #                    #   
   #                    #                                                              #                    #                    #                    #   
   #                    #                    #                    #                    #                    #                    #                    #   
   #                    #                    #                    #                    #                    #                    #                    #   
   #                    #                    #                    #                    #                    #                    #                    #   
##############       ##############       ##############       ###################################       #################################################
   #                    #                    #                    #                    #                    #                    #                    #   
   #                    #                    #                    #                    #                    #                    #                    #   
   #                    #                    #                    #                    #                    #                    #                    #   
   #                                         #                    #                                         #                    #                    #   
   #                                         #                    #                                         #                    #                    #   
   #                                         #                    #                                         #                    #                    #   
   #                                         #                    #                                         #                    #                    #   
   #                                         #                    #                                         #                    #                    #   
   #                                         #                    #                                         #                    #                    #   
   #                                         #                    #                                         #                    #                    #   
   #                    #                    #                    #                    #                                                              #   
   #                    #                    #                    #                    #                                                              #   
   #                    #                    #                    #                    #                                                              #   
   #                    #                    #                    #                    #                                                              #   
   #                    #                    #                    #                    #                                                              #   
   #                    #                    #                    #                    #                                                              #   
   #                    #                    #                    #                    #                                                              #   
   #                    #                    #                    #                    #                                                              #   
   #                    #                    #                    #                    #                                                              #   
   #                    #                    #                    #                    #                                                              #   
##########################################################################################################################################################
   #                    #                    #                    #                    #                                                              #   
   #                    #                    #                    #                    #                                                              #   
   #                    #                    #                    #                    #                                                              #   