################
#@   #     #   #
#    ### ###   #
#    #         #
#    #     ## ##
#    #     #   #
### ##     #   #
#    #     #   #
#    #     #   #
#          #   #
######### ##   #
#      #   #   #
#### ### ###   #
#          #   #
#      #   #   #
################