################
#@       #  #  #
#        #  #  #
# ########  #  #
#        #  #  #
#        #  #  #
#           #  #
#        #  #  #
#        #  #  #
#        #     #
###### ###  #  #
#    #   #  #  #
#        #  #  #
#    #   #  #  #
#    #   #  #  #
################