################
#@     #  #  # #
### ##### ## # #
#         #  # #
# #    ## #  # #
#### ###  #  # #
#      #     # #
#      #  #  # #
#      #  #  # #
#### ###  #  # #
#      #  #  # #
#      #  #    #
#      #  #  # #
#      #  #  # #
#      #  #  # #
################