################
#@#   #  # # # #
# ### #  # # # #
# #   #  # # # #
# # ###    # # #
# #   #  #   # #
#        # # # #
# #   #  # # # #
# #   #  # # # #
# #   ## ### # #
# #   #  # # # #
# #   #  # #   #
# #   #  # # # #
# #   #    # # #
# #   #  # # # #
################