################
#@             #
### ############
#     #   #    #
#     #   #    #
#     #   #    #
#     #   ## ###
#              #
#     #   #    #
######## #######
#          #   #
#          #   #
### ######## ###
#              #
#          # # #
################