################
#@ # # #   # # #
#  # # #   # # #
#  # # #   # # #
#  # # #   # # #
#  # # #   #   #
#  # # #     # #
#  # #     # # #
#  # ######### #
#  # #         #
#    #     #   #
#  #       #   #
#  # ### #######
#  # #         #
#  # #     #   #
################