################
#@  # # #   #  #
#   # # #   #  #
#   # # #   #  #
#   # # #   #  #
#     #     #  #
#   # # #   #  #
#   # # #      #
## #### #   #  #
#   # # #   #  #
#   # # #   #  #
#       #   #  #
# ##### # ######
#     # # #    #
#     # #      #
################