   #                    #                    #                    #                    #                    #                    #                    #   
   #                    #                    #                    #                    #                    #                    #                    #   
   #                    #                    #                    #                    #                    #                    #                    #   
##########################################################################################################################################################
   #                    #                    #                    #                    #                    #                    #                    #   
   #                    #                    #                    #                    #                    #                    #                    #   
   #                    #                    #                    #                    #                    #                    #                    #   
   #                    #                    #                    #                    #                    #                    #                    #   
   #                    #                    #                    #                    #                    #                    #                    #   
   #                    #                    #                    #                    #                    #                    #                    #   
   #      @             #                    #                    #                    #                    #                    #                    #   
   #                    #                    #                    #                    #                    #                    #                    #   
   #                    #                    #                    #                    #                    #                    #                    #   
   #                    #                    #                    #                    #                    #                    #                    #   
   #                                         #                                                              #                    #                    #   
   #                                         #                                                              #                    #                    #   
   #                                         #                                                              #                    #                    #   
   #                                         #                                                              #                    #                    #   
   #                                         #                                                              #                    #                    #   
   #                                         #                                                              #                    #                    #   
   #                                         #                                                              #                    #                    #   
   #                    #                    #                    #                    #                    #                    #                    #   
   #                    #                    #                    #                    #                    #                    #                    #   
   #                    #                    #                    #                    #                    #                    #                    #   
##############       ##############          #          ###############################################################          #          ##############
   #                    #                    #                    #                    #                    #                    #                    #   
   #                    #                    #                    #                    #                    #                    #                    #   
   #                    #                    #                    #                    #                    #                    #                    #   
   #                    #                                         #                    #                    #                    #                    #   
   #                    #                                         #                    #                    #                    #                    #   
   #                    #                                         #                    #                    #                    #                    #   
   #                    #                                         #                    #                    #                    #                    #   
   #                    #                                         #                    #                    #                    #                    #   
   #                    #                                         #                    #                    #                    #                    #   
   #                    #                                         #                    #                    #                    #                    #   
   #                    #                    #                    #                    #                                                              #   
   #                    #                    #                    #                    #                                                              #   
   #                    #                    #                    #                    #                                                              #   
   #                    #                    #                    #                    #                                                              #   
   #                    #                    #                    #                    #                                                              #   
   #                    #                    #                    #                    #                                                              #   
   #                    #                    #                    #                    #                                                              #   
   #                    #                    #                    #                    #                    #                                         #   
   #                    #                    #                    #                    #                    #                                         #   
   #                    #                    #                    #                    #                    #                                         #   
   #          #####################          #          #####################       #################################################       ##############
   #                    #                    #                    #                    #                    #                                         #   
   #                    #                    #                    #                    #                    #                                         #   
   #                    #                    #                    #                    #                    #                                         #   
   #                    #                    #                    #                    #                    #                                         #   
   #                    #                    #                    #                    #                    #                                         #   
   #                    #                    #                    #                    #                    #                                         #   
   #                    #                    #                    #                    #                    #                                         #   
   #                    #                    #                    #                    #                    #                                         #   
   #                    #                    #                    #                    #                    #                                         #   
   #                    #                    #                    #                    #                    #                                         #   
   #                    #                    #                    #                                                              #                    #   
   #                    #                    #                    #                                                              #                    #   
   #                    #                    #                    #                                                              #                    #   
   #                    #                    #                    #                                                              #                    #   
   #                    #                    #                    #                                                              #                    #   
   #                    #                    #                    #                                                              #                    #   
   #                    #                    #                    #                                                              #                    #   
   #                    #                    #                    #                    #                    #                    #                    #   
   #                    #                    #                    #                    #                    #                    #                    #   
   #                    #                    #                    #                    #                    #                    #                    #   
############################       ########################################################       ###################################       ##############
   #                    #                    #                    #                    #                    #                    #                    #   
   #                    #                    #                    #                    #                    #                    #                    #   
   #                    #                    #                    #                    #                    #                    #                    #   
   #                    #                                                              #                    #                    #                    #   
   #                    #                                                              #                    #                    #                    #   
   #                    #                                                              #                    #                    #                    #   
   #                    #                                                              #                    #                    #                    #   
   #                    #                                                              #                    #                    #                    #   
   #                    #                                                              #                    #                    #                    #   
   #                    #                                                              #                    #                    #                    #   
   #                                         #                    #                                         #                                         #   
   #                                         #                    #                                         #                                         #   
   #                                         #                    #                                         #                                         #   
   #                                         #                    #                                         #                                         #   
   #                                         #                    #                                         #                                         #   
   #                                         #                    #                                         #                                         #   
   #                                         #                    #                                         #                                         #   
   #                                         #                    #                    #                    #                    #                    #   
   #                                         #                    #                    #                    #                    #                    #   
   #                                         #                    #                    #                    #                    #                    #   
###################################       ############################       #############################################################################
   #                                         #                    #                    #                    #                    #                    #   
   #                                         #                    #                    #                    #                    #                    #   
   #                                         #                    #                    #                    #                    #                    #   
   #                                                              #                    #                    #                    #                    #   
   #                                                              #                    #                    #                    #                    #   
   #                                                              #                    #                    #                    #                    #   
   #                                                              #                    #                    #                    #                    #   
   #                                                              #                    #                    #                    #                    #   
   #                                                              #                    #                    #                    #                    #   
   #                                                              #                    #                    #                    #                    #   
   #                    #                    #                    #                                                                                   #   
   #                    #                    #                    #                                                                                   #   
   #                    #                    #                    #                                                                                   #   
   #                    #                    #                    #                                                                                   #   
   #                    #                    #                    #                                                                                   #   
   #                    #                    #                    #                                                                                   #   
   #                    #                    #                    #                                                                                   #   
   #                    #                    #                    #                    #                    #                    #                    #   
   #                    #                    #                    #                    #                    #                    #                    #   
   #                    #                    #                    #                    #                    #                    #                    #   
############################       ##############       ###################################       ##########################################          #   
   #                    #                    #                    #                    #                    #                    #                    #   
   #                    #                    #                    #                    #                    #                    #                    #   
   #                    #                    #                    #                    #                    #                    #                    #   
   #                    #                    #                    #                    #                    #                    #                    #   
   #                    #                    #                    #                    #                    #                    #                    #   
   #                    #                    #                    #                    #                    #                    #                    #   
   #                    #                    #                    #                    #                    #                    #                    #   
   #                    #                    #                    #                    #                    #                    #                    #   
   #                    #                    #                    #                    #                    #                    #                    #   
   #                    #                    #                    #                    #                    #                    #                    #   
   #                                         #                    #                                         #                    #                    #   
   #                                         #                    #                                         #                    #                    #   
   #                                         #                    #                                         #                    #                    #   
   #                                         #                    #                                         #                    #                    #   
   #                                         #                    #                                         #                    #                    #   
   #                                         #                    #                                         #                    #                    #   
   #                                         #                    #                                         #                    #                    #   
   #                                         #                    #                    #                    #                    #                    #   
   #                                         #                    #                    #                    #                    #                    #   
   #                                         #                    #                    #                    #                    #                    #   
##############       #################################################       ###################################       ###################################
   #                                         #                    #                    #                    #                    #                    #   
   #                                         #                    #                    #                    #                    #                    #   
   #                                         #                    #                    #                    #                    #                    #   
   #                                                              #                    #                    #                                         #   
   #                                                              #                    #                    #                                         #   
   #                                                              #                    #                    #                                         #   
   #                                                              #                    #                    #                                         #   
   #                                                              #                    #                    #                                         #   
   #                                                              #                    #                    #                                         #   
   #                                                              #                    #                    #                                         #   
   #                    #                    #                    #                                                              #                    #   
   #                    #                    #                    #                                                              #                    #   
   #                    #                    #                    #                                                              #                    #   
   #                    #                    #                    #                                                              #                    #   
   #                    #                    #                    #                                                              #                    #   
   #                    #                    #                    #                                                              #                    #   
   #                    #                    #                    #                                                              #                    #   
   #                    #                    #                    #                                                              #                    #   
   #                    #                    #                    #                                                              #                    #   
   #                    #                    #                    #                                                              #                    #   
##########################################################################################################################################################
   #                    #                    #                    #                                                              #                    #   
   #                    #                    #                    #                                                              #                    #   
   #                    #                    #                    #                                                              #                    #   