################
#@       #     #
####### ###### #
#        #     #
######## #     #
# # #    #     #
# # #    ### ###
# # #    #     #
# # #    #     #
# # #    #     #
# #      #     #
# # #    #     #
# # #    ### ###
#   ## ###     #
# # #        # #
################