################
#@ #      #    #
#  #      #    #
#  #      #    #
#  #           #
#  ## ##########
#  #           #
#  ### #########
#  #           #
#  #           #
#  ##### #######
#  #           #
#  ########### #
#      #       #
#  #           #
################