################
#@         # # #
######## ### # #
#            # #
#          # # #
#          # # #
#          #   #
#          # # #
#### ###########
#              #
### ############
#              #
#              #
##### ##########
#              #
################