################
#@ # #         #
#              #
####### ########
#     #  # # # #
#        # # # #
#     #  # # # #
#     #  # # # #
## ####### # # #
#    #     # # #
#    #   # # # #
#        # # # #
#    #   #   # #
#    #   # # # #
#    #   # #   #
################