   #                                         #                                         #                    #                    #                    #   
   #                                         #                                         #                    #                    #                    #   
   #                                         #                                         #                    #                    #                    #   
##########################################################################################################################################################
   #                                         #                                         #                    #                    #                    #   
   #                                         #                                         #                    #                    #                    #   
   #                                         #                                         #                    #                    #                    #   
   #                                         #                                         #                    #                    #                    #   
   #                                         #                                         #                    #                    #                    #   
   #                                         #                                         #                    #                    #                    #   
   #      @                                  #                                         #                    #                    #                    #   
   #                                         #                                         #                    #                    #                    #   
   #                                         #                                         #                    #                    #                    #   
   #                                         #                                         #                    #                    #                    #   
   #                    #                                         #                                                              #                    #   
   #                    #                                         #                                                              #                    #   
   #                    #                                         #                                                              #                    #   
   #                    #                                         #                                                              #                    #   
   #                    #                                         #                                                              #                    #   
   #                    #                                         #                                                              #                    #   
   #                    #                                         #                                                              #                    #   
   #                    #                    #                    #                    #                                         #                    #   
   #                    #                    #                    #                    #                                         #                    #   
   #                    #                    #                    #                    #                                         #                    #   
   #          ##############       ##########################################       ############################       #####################          #   
   #                    #                    #                    #                    #                                         #                    #   
   #                    #                    #                    #                    #                                         #                    #   
   #                    #                    #                    #                    #                                         #                    #   
   #                    #                    #                    #                    #                                         #                    #   
   #                    #                    #                    #                    #                                         #                    #   
   #                    #                    #                    #                    #                                         #                    #   
   #                    #                    #                    #                    #                                         #                    #   
   #                    #                    #                    #                    #                                         #                    #   
   #                    #                    #                    #                    #                                         #                    #   
   #                    #                    #                    #                    #                                         #                    #   
   #                    #                                         #                    #                    #                                         #   
   #                    #                                         #                    #                    #                                         #   
   #                    #                                         #                    #                    #                                         #   
   #                    #                                         #                    #                    #                                         #   
   #                    #                                         #                    #                    #                                         #   
   #                    #                                         #                    #                    #                                         #   
   #                    #                                         #                    #                    #                                         #   
   #                    #                    #                    #                    #                    #                    #                    #   
   #                    #                    #                    #                    #                    #                    #                    #   
   #                    #                    #                    #                    #                    #                    #                    #   
##############          #          #############################################################################       ###################################
   #                    #                    #                    #                    #                    #                    #                    #   
   #                    #                    #                    #                    #                    #                    #                    #   
   #                    #                    #                    #                    #                    #                    #                    #   
   #                    #                    #                    #                    #                    #                    #                    #   
   #                    #                    #                    #                    #                    #                    #                    #   
   #                    #                    #                    #                    #                    #                    #                    #   
   #                    #                    #                    #                    #                    #                    #                    #   
   #                    #                    #                    #                    #                    #                    #                    #   
   #                    #                    #                    #                    #                    #                    #                    #   
   #                    #                    #                    #                    #                    #                    #                    #   
   #                    #                                                              #                                         #                    #   
   #                    #                                                              #                                         #                    #   
   #                    #                                                              #                                         #                    #   
   #                    #                                                              #                                         #                    #   
   #                    #                                                              #                                         #                    #   
   #                    #                                                              #                                         #                    #   
   #                    #                                                              #                                         #                    #   
   #                    #                    #                                         #                    #                    #                    #   
   #                    #                    #                                         #                    #                    #                    #   
   #                    #                    #                                         #                    #                    #                    #   
##############       #############################################################################          #          ##############       ##############
   #                    #                    #                                         #                    #                    #                    #   
   #                    #                    #                                         #                    #                    #                    #   
   #                    #                    #                                         #                    #                    #                    #   
   #                    #                    #                                         #                    #                                         #   
   #                    #                    #                                         #                    #                                         #   
   #                    #                    #                                         #                    #                                         #   
   #                    #                    #                                         #                    #                                         #   
   #                    #                    #                                         #                    #                                         #   
   #                    #                    #                                         #                    #                                         #   
   #                    #                    #                                         #                    #                                         #   
   #                                                              #                    #                    #                    #                    #   
   #                                                              #                    #                    #                    #                    #   
   #                                                              #                    #                    #                    #                    #   
   #                                                              #                    #                    #                    #                    #   
   #                                                              #                    #                    #                    #                    #   
   #                                                              #                    #                    #                    #                    #   
   #                                                              #                    #                    #                    #                    #   
   #                    #                    #                    #                    #                    #                    #                    #   
   #                    #                    #                    #                    #                    #                    #                    #   
   #                    #                    #                    #                    #                    #                    #                    #   
##############       ###################################       ########################################################       ############################
   #                    #                    #                    #                    #                    #                    #                    #   
   #                    #                    #                    #                    #                    #                    #                    #   
   #                    #                    #                    #                    #                    #                    #                    #   
   #                    #                    #                    #                                         #                                         #   
   #                    #                    #                    #                                         #                                         #   
   #                    #                    #                    #                                         #                                         #   
   #                    #                    #                    #                                         #                                         #   
   #                    #                    #                    #                                         #                                         #   
   #                    #                    #                    #                                         #                                         #   
   #                    #                    #                    #                                         #                                         #   
   #                                         #                                         #                    #                    #                    #   
   #                                         #                                         #                    #                    #                    #   
   #                                         #                                         #                    #                    #                    #   
   #                                         #                                         #                    #                    #                    #   
   #                                         #                                         #                    #                    #                    #   
   #                                         #                                         #                    #                    #                    #   
   #                                         #                                         #                    #                    #                    #   
   #                    #                    #                    #                    #                    #                    #                    #   
   #                    #                    #                    #                    #                    #                    #                    #   
   #                    #                    #                    #                    #                    #                    #                    #   
   #          ###################################       ##############       #####################       ##############          #          ##############
   #                    #                    #                    #                    #                    #                    #                    #   
   #                    #                    #                    #                    #                    #                    #                    #   
   #                    #                    #                    #                    #                    #                    #                    #   
   #                    #                    #                    #                    #                    #                    #                    #   
   #                    #                    #                    #                    #                    #                    #                    #   
   #                    #                    #                    #                    #                    #                    #                    #   
   #                    #                    #                    #                    #                    #                    #                    #   
   #                    #                    #                    #                    #                    #                    #                    #   
   #                    #                    #                    #                    #                    #                    #                    #   
   #                    #                    #                    #                    #                    #                    #                    #   
   #                                         #                    #                    #                    #                    #                    #   
   #                                         #                    #                    #                    #                    #                    #   
   #                                         #                    #                    #                    #                    #                    #   
   #                                         #                    #                    #                    #                    #                    #   
   #                                         #                    #                    #                    #                    #                    #   
   #                                         #                    #                    #                    #                    #                    #   
   #                                         #                    #                    #                    #                    #                    #   
   #                    #                    #                    #                    #                    #                    #                    #   
   #                    #                    #                    #                    #                    #                    #                    #   
   #                    #                    #                    #                    #                    #                    #                    #   
   #          #####################       ##############       ##############          #          #####################          #          ##############
   #                    #                    #                    #                    #                    #                    #                    #   
   #                    #                    #                    #                    #                    #                    #                    #   
   #                    #                    #                    #                    #                    #                    #                    #   
   #                    #                    #                    #                    #                    #                    #                    #   
   #                    #                    #                    #                    #                    #                    #                    #   
   #                    #                    #                    #                    #                    #                    #                    #   
   #                    #                    #                    #                    #                    #                    #                    #   
   #                    #                    #                    #                    #                    #                    #                    #   
   #                    #                    #                    #                    #                    #                    #                    #   
   #                    #                    #                    #                    #                    #                    #                    #   
   #                    #                    #                    #                    #                    #                    #                    #   
   #                    #                    #                    #                    #                    #                    #                    #   
   #                    #                    #                    #                    #                    #                    #                    #   
   #                    #                    #                    #                    #                    #                    #                    #   
   #                    #                    #                    #                    #                    #                    #                    #   
   #                    #                    #                    #                    #                    #                    #                    #   
   #                    #                    #                    #                    #                    #                    #                    #   
   #                    #                    #                    #                    #                    #                    #                    #   
   #                    #                    #                    #                    #                    #                    #                    #   
   #                    #                    #                    #                    #                    #                    #                    #   
##########################################################################################################################################################
   #                    #                    #                    #                    #                    #                    #                    #   
   #                    #                    #                    #                    #                    #                    #                    #   
   #                    #                    #                    #                    #                    #                    #                    #   