################
#@             #
############ ###
# #          # #
# #          # #
# #          # #
# #          # #
# ######### ## #
# #          # #
# #          # #
# #          # #
# #          # #
# #            #
# #          # #
#            # #
################