################
#@ #    #      #
#       #      #
#  #           #
#  #    #      #
#  #    #      #
## #    #      #
#  ######### ###
#  #           #
#  ## ##########
#  #           #
######## #######
#  #           #
#          ### #
#  #       #   #
################