################
#@       #  #  #
# # #          #
####### ########
#   #   #      #
#   #   #      #
#   #   ###### #
#              #
#   #   #      #
#   #   #      #
#   #   #      #
#   # ###      #
## ##   #      #
#   #   #      #
#   #   #      #
################