################
#@ #     #  #  #
#  #     #  #  #
#  #     #  #  #
#  #     #  #  #
#  #     #     #
#        #  #  #
#  #        #  #
#  #     #  #  #
############# ##
#     # #      #
#              #
############## #
#              #
#              #
################