################
#@  #   #  # # #
#   # ### ## # #
#   # # #  # # #
#   # # # ## # #
## ## # #  # # #
#   # # #  # # #
#   # # #  #   #
#   # # #  # # #
#   # # #  # # #
#   # # #  # # #
### # # #  # # #
#   # # #  # # #
#     # #    # #
#   #      # # #
################