################
#@          #  #
#      #       #
#      #    #  #
##### ##    #  #
#      #    #  #
######### ######
#              #
####### ########
#              #
############# ##
#              #
#              #
######### ######
#              #
################