################
#@ #         # #
#  #         # #
#  #         # #
#  #           #
#  ####### ### #
#  #         # #
#  #         # #
## #         # #
#            # #
#  #         # #
############## #
#    #         #
# #            #
# #  #         #
################