################
#@           # #
## ########### #
#              #
#            # #
######### ######
#              #
####### ########
#              #
######### ######
#          #   #
# ###### ###   #
# #        ## ##
# #            #
# #        #   #
################