################
#@             #
# ##############
#              #
########### ####
#      # #     #
#        #     #
#      # #     #
#      # #### ##
#      #       #
############## #
#       #  #   #
####### #  # # #
#            # #
#     # #  # # #
################