################
#@# #          #
# # ###### #####
# # #          #
# # # ##########
# # #    #     #
# #      #     #
# # #    #     #
# # #    #     #
# # #    #     #
# # #    #     #
#   #          #
# # #    #     #
# # #    #     #
# # #    #     #
################