################
#@             #
# ##############
# #     #   #  #
# #     #   #  #
#       #   #  #
# #     #   #  #
# ## ####   #  #
# #     #   #  #
# #     ## ##  #
# #     #   #  #
# #     #   # ##
# #     #   #  #
# #         #  #
# #     #      #
################