################
#@             #
############ ###
#              #
#              #
######## #######
# #            #
#    #         #
############# ##
#              #
###### #########
#         #    #
#         #    #
#         #    #
#              #
################