################
#@  # # #  # # #
#   # # #  # # #
#   # # #  # # #
#   # # #  # # #
#   #   #  # # #
#   # # #  # # #
#   # # #  # # #
### # # #    # #
#   # # #  # # #
#   # # #  # # #
### # # #  #   #
#     # #  # # #
# ### #    # # #
#   # # #  # # #
################