################
#@      #  #   #
#       #  # # #
#### ####  # # #
#       #  # # #
## ######  # # #
#       #  # # #
# #######    # #
#       #  # # #
#       #  # # #
#### ####  # # #
#       #  # # #
#          # # #
#       #  # # #
#       #  # # #
################