################
#@#   #  #   # #
#        #   # #
### ######   # #
#        #   # #
### ###### ### #
#        #   # #
#            # #
#        #     #
#        #   # #
# ######### ####
#        #     #
#        ## ####
### ######     #
#        #     #
################