   #                                                              #                    #                                         #                    #   
   #                                                              #                    #                                         #                    #   
   #                                                              #                    #                                         #                    #   
##########################################################################################################################################################
   #                                                              #                    #                                         #                    #   
   #                                                              #                    #                                         #                    #   
   #                                                              #                    #                                         #                    #   
   #                                                              #                    #                                         #                    #   
   #                                                              #                    #                                         #                    #   
   #                                                              #                    #                                         #                    #   
   #      @                                                       #                    #                                         #                    #   
   #                                                              #                    #                                         #                    #   
   #                                                              #                    #                                         #                    #   
   #                                                              #                    #                                         #                    #   
   #                    #                    #                                         #                    #                                         #   
   #                    #                    #                                         #                    #                                         #   
   #                    #                    #                                         #                    #                                         #   
   #                    #                    #                                         #                    #                                         #   
   #                    #                    #                                         #                    #                                         #   
   #                    #                    #                                         #                    #                                         #   
   #                    #                    #                                         #                    #                                         #   
   #                    #                    #                    #                    #                    #                                         #   
   #                    #                    #                    #                    #                    #                                         #   
   #                    #                    #                    #                    #                    #                                         #   
###################################       ##############       ############################       ########################################################
   #                    #                    #                    #                    #                    #                                         #   
   #                    #                    #                    #                    #                    #                                         #   
   #                    #                    #                    #                    #                    #                                         #   
   #                    #                    #                    #                    #                    #                                         #   
   #                    #                    #                    #                    #                    #                                         #   
   #                    #                    #                    #                    #                    #                                         #   
   #                    #                    #                    #                    #                    #                                         #   
   #                    #                    #                    #                    #                    #                                         #   
   #                    #                    #                    #                    #                    #                                         #   
   #                    #                    #                    #                    #                    #                                         #   
   #                    #                    #                                         #                    #                    #                    #   
   #                    #                    #                                         #                    #                    #                    #   
   #                    #                    #                                         #                    #                    #                    #   
   #                    #                    #                                         #                    #                    #                    #   
   #                    #                    #                                         #                    #                    #                    #   
   #                    #                    #                                         #                    #                    #                    #   
   #                    #                    #                                         #                    #                    #                    #   
   #                    #                    #                    #                    #                    #                    #                    #   
   #                    #                    #                    #                    #                    #                    #                    #   
   #                    #                    #                    #                    #                    #                    #                    #   
   #          #####################       ########################################################          #          ###################################
   #                    #                    #                    #                    #                    #                    #                    #   
   #                    #                    #                    #                    #                    #                    #                    #   
   #                    #                    #                    #                    #                    #                    #                    #   
   #                                                              #                                                              #                    #   
   #                                                              #                                                              #                    #   
   #                                                              #                                                              #                    #   
   #                                                              #                                                              #                    #   
   #                                                              #                                                              #                    #   
   #                                                              #                                                              #                    #   
   #                                                              #                                                              #                    #   
   #                    #                    #                                         #                    #                                         #   
   #                    #                    #                                         #                    #                                         #   
   #                    #                    #                                         #                    #                                         #   
   #                    #                    #                                         #                    #                                         #   
   #                    #                    #                                         #                    #                                         #   
   #                    #                    #                                         #                    #                                         #   
   #                    #                    #                                         #                    #                                         #   
   #                    #                    #                    #                    #                    #                                         #   
   #                    #                    #                    #                    #                    #                                         #   
   #                    #                    #                    #                    #                    #                                         #   
##############       ############################       ###############################################################       ############################
   #                    #                    #                    #                    #                    #                                         #   
   #                    #                    #                    #                    #                    #                                         #   
   #                    #                    #                    #                    #                    #                                         #   
   #                                         #                    #                    #                                                              #   
   #                                         #                    #                    #                                                              #   
   #                                         #                    #                    #                                                              #   
   #                                         #                    #                    #                                                              #   
   #                                         #                    #                    #                                                              #   
   #                                         #                    #                    #                                                              #   
   #                                         #                    #                    #                                                              #   
   #                    #                    #                    #                    #                    #                    #                    #   
   #                    #                    #                    #                    #                    #                    #                    #   
   #                    #                    #                    #                    #                    #                    #                    #   
   #                    #                    #                    #                    #                    #                    #                    #   
   #                    #                    #                    #                    #                    #                    #                    #   
   #                    #                    #                    #                    #                    #                    #                    #   
   #                    #                    #                    #                    #                    #                    #                    #   
   #                    #                    #                    #                    #                    #                    #                    #   
   #                    #                    #                    #                    #                    #                    #                    #   
   #                    #                    #                    #                    #                    #                    #                    #   
##############       ############################       #####################       ##############       ############################       ##############
   #                    #                    #                    #                    #                    #                    #                    #   
   #                    #                    #                    #                    #                    #                    #                    #   
   #                    #                    #                    #                    #                    #                    #                    #   
   #                    #                    #                                         #                                         #                    #   
   #                    #                    #                                         #                                         #                    #   
   #                    #                    #                                         #                                         #                    #   
   #                    #                    #                                         #                                         #                    #   
   #                    #                    #                                         #                                         #                    #   
   #                    #                    #                                         #                                         #                    #   
   #                    #                    #                                         #                                         #                    #   
   #                                         #                    #                    #                    #                    #                    #   
   #                                         #                    #                    #                    #                    #                    #   
   #                                         #                    #                    #                    #                    #                    #   
   #                                         #                    #                    #                    #                    #                    #   
   #                                         #                    #                    #                    #                    #                    #   
   #                                         #                    #                    #                    #                    #                    #   
   #                                         #                    #                    #                    #                    #                    #   
   #                    #                    #                    #                    #                    #                    #                    #   
   #                    #                    #                    #                    #                    #                    #                    #   
   #                    #                    #                    #                    #                    #                    #                    #   
   #          ##########################################       ##############       ###################################          #          ##############
   #                    #                    #                    #                    #                    #                    #                    #   
   #                    #                    #                    #                    #                    #                    #                    #   
   #                    #                    #                    #                    #                    #                    #                    #   
   #                    #                    #                    #                    #                    #                    #                    #   
   #                    #                    #                    #                    #                    #                    #                    #   
   #                    #                    #                    #                    #                    #                    #                    #   
   #                    #                    #                    #                    #                    #                    #                    #   
   #                    #                    #                    #                    #                    #                    #                    #   
   #                    #                    #                    #                    #                    #                    #                    #   
   #                    #                    #                    #                    #                    #                    #                    #   
   #                                         #                    #                                         #                    #                    #   
   #                                         #                    #                                         #                    #                    #   
   #                                         #                    #                                         #                    #                    #   
   #                                         #                    #                                         #                    #                    #   
   #                                         #                    #                                         #                    #                    #   
   #                                         #                    #                                         #                    #                    #   
   #                                         #                    #                                         #                    #                    #   
   #                                         #                    #                    #                    #                    #                    #   
   #                                         #                    #                    #                    #                    #                    #   
   #                                         #                    #                    #                    #                    #                    #   
   #          ###############################################################       ######################################################################
   #                                         #                    #                    #                    #                    #                    #   
   #                                         #                    #                    #                    #                    #                    #   
   #                                         #                    #                    #                    #                    #                    #   
   #                                         #                                         #                                         #                    #   
   #                                         #                                         #                                         #                    #   
   #                                         #                                         #                                         #                    #   
   #                                         #                                         #                                         #                    #   
   #                                         #                                         #                                         #                    #   
   #                                         #                                         #                                         #                    #   
   #                                         #                                         #                                         #                    #   
   #                    #                    #                    #                                         #                                         #   
   #                    #                    #                    #                                         #                                         #   
   #                    #                    #                    #                                         #                                         #   
   #                    #                    #                    #                                         #                                         #   
   #                    #                    #                    #                                         #                                         #   
   #                    #                    #                    #                                         #                                         #   
   #                    #                    #                    #                                         #                                         #   
   #                    #                    #                    #                                         #                                         #   
   #                    #                    #                    #                                         #                                         #   
   #                    #                    #                    #                                         #                                         #   
##########################################################################################################################################################
   #                    #                    #                    #                                         #                                         #   
   #                    #                    #                    #                                         #                                         #   
   #                    #                    #                    #                                         #                                         #   