################
#@             #
#  #           #
############ ###
#              #
#         #    #
#         #    #
#         #    #
####### ########
#              #
### ############
#              #
# ###### #######
# #            #
# #            #
################