################
#@ #     #   # #
#  #     #   # #
#  #         # #
#  #     #   # #
#  #     # ### #
#  #     #   # #
#        #   # #
## ########### #
#   #   #    # #
#   #   #    # #
#       ## ### #
#   #   #    # #
#   #          #
#   #   #    # #
################