################
#@ #     #  #  #
#           #  #
#  #     #  #  #
####### #####  #
#     #     #  #
#     #     #  #
#     #     #  #
#     #     #  #
#     #        #
#     #     #  #
#     ##### #  #
#           #  #
#### ##     # ##
#     #     #  #
################