################
#@             #
############ ###
#              #
###### #########
#              #
#              #
## #############
#   #        # #
#            # #
#   #        # #
#   #        # #
#   #          #
#   ######## # #
#   #        # #
################