################
#@ # #  #    # #
#  # #  #    # #
#  # #  #    # #
#  # #  #    # #
#  # #  #    # #
#    #  #    # #
#  # #  #    # #
#  # #  #    # #
#  # #  #    # #
#  # #       # #
#  #    #    # #
#  # #  #      #
############ ###
#              #
################