################
#@             #
########### ####
#              #
############# ##
#              #
#              #
# ##############
#              #
############ ###
#              #
########## #####
#              #
############## #
#              #
################