################
#@             #
######## #######
#              #
## #############
#              #
############# ##
#              #
######### ######
#              #
#              #
######### ######
#              #
######## #######
#              #
################