################
#@             #
## #############
#              #
############# ##
#     #        #
#     #        #
#     #        #
#              #
############ ###
#              #
#              #
############## #
#              #
#              #
################