   #                                                                                                        #                    #                    #   
   #                                                                                                        #                    #                    #   
   #                                                                                                        #                    #                    #   
##########################################################################################################################################################
   #                                                                                                        #                    #                    #   
   #                                                                                                        #                    #                    #   
   #                                                                                                        #                    #                    #   
   #                                                                                                        #                    #                    #   
   #                                                                                                        #                    #                    #   
   #                                                                                                        #                    #                    #   
   #      @                                                                                                 #                    #                    #   
   #                                                                                                        #                    #                    #   
   #                                                                                                        #                    #                    #   
   #                                                                                                        #                    #                    #   
   #                    #                    #                    #                    #                                                              #   
   #                    #                    #                    #                    #                                                              #   
   #                    #                    #                    #                    #                                                              #   
   #                    #                    #                    #                    #                                                              #   
   #                    #                    #                    #                    #                                                              #   
   #                    #                    #                    #                    #                                                              #   
   #                    #                    #                    #                    #                                                              #   
   #                    #                    #                    #                    #                    #                    #                    #   
   #                    #                    #                    #                    #                    #                    #                    #   
   #                    #                    #                    #                    #                    #                    #                    #   
   #          ##############       ##########################################       ###################################       ############################
   #                    #                    #                    #                    #                    #                    #                    #   
   #                    #                    #                    #                    #                    #                    #                    #   
   #                    #                    #                    #                    #                    #                    #                    #   
   #                    #                    #                    #                                         #                    #                    #   
   #                    #                    #                    #                                         #                    #                    #   
   #                    #                    #                    #                                         #                    #                    #   
   #                    #                    #                    #                                         #                    #                    #   
   #                    #                    #                    #                                         #                    #                    #   
   #                    #                    #                    #                                         #                    #                    #   
   #                    #                    #                    #                                         #                    #                    #   
   #                    #                                         #                    #                    #                                         #   
   #                    #                                         #                    #                    #                                         #   
   #                    #                                         #                    #                    #                                         #   
   #                    #                                         #                    #                    #                                         #   
   #                    #                                         #                    #                    #                                         #   
   #                    #                                         #                    #                    #                                         #   
   #                    #                                         #                    #                    #                                         #   
   #                    #                    #                    #                    #                    #                    #                    #   
   #                    #                    #                    #                    #                    #                    #                    #   
   #                    #                    #                    #                    #                    #                    #                    #   
   #          #####################       ############################       ##########################################       ############################
   #                    #                    #                    #                    #                    #                    #                    #   
   #                    #                    #                    #                    #                    #                    #                    #   
   #                    #                    #                    #                    #                    #                    #                    #   
   #                    #                    #                    #                    #                    #                    #                    #   
   #                    #                    #                    #                    #                    #                    #                    #   
   #                    #                    #                    #                    #                    #                    #                    #   
   #                    #                    #                    #                    #                    #                    #                    #   
   #                    #                    #                    #                    #                    #                    #                    #   
   #                    #                    #                    #                    #                    #                    #                    #   
   #                    #                    #                    #                    #                    #                    #                    #   
   #                    #                    #                    #                    #                    #                    #                    #   
   #                    #                    #                    #                    #                    #                    #                    #   
   #                    #                    #                    #                    #                    #                    #                    #   
   #                    #                    #                    #                    #                    #                    #                    #   
   #                    #                    #                    #                    #                    #                    #                    #   
   #                    #                    #                    #                    #                    #                    #                    #   
   #                    #                    #                    #                    #                    #                    #                    #   
   #                    #                    #                    #                    #                    #                    #                    #   
   #                    #                    #                    #                    #                    #                    #                    #   
   #                    #                    #                    #                    #                    #                    #                    #   
###################################          #          ##########################################       ############################       ##############
   #                    #                    #                    #                    #                    #                    #                    #   
   #                    #                    #                    #                    #                    #                    #                    #   
   #                    #                    #                    #                    #                    #                    #                    #   
   #                    #                                         #                    #                    #                                         #   
   #                    #                                         #                    #                    #                                         #   
   #                    #                                         #                    #                    #                                         #   
   #                    #                                         #                    #                    #                                         #   
   #                    #                                         #                    #                    #                                         #   
   #                    #                                         #                    #                    #                                         #   
   #                    #                                         #                    #                    #                                         #   
   #                    #                    #                    #                    #                                         #                    #   
   #                    #                    #                    #                    #                                         #                    #   
   #                    #                    #                    #                    #                                         #                    #   
   #                    #                    #                    #                    #                                         #                    #   
   #                    #                    #                    #                    #                                         #                    #   
   #                    #                    #                    #                    #                                         #                    #   
   #                    #                    #                    #                    #                                         #                    #   
   #                    #                    #                    #                    #                    #                    #                    #   
   #                    #                    #                    #                    #                    #                    #                    #   
   #                    #                    #                    #                    #                    #                    #                    #   
   #          ##############       ###################################       ##########################################       ############################
   #                    #                    #                    #                    #                    #                    #                    #   
   #                    #                    #                    #                    #                    #                    #                    #   
   #                    #                    #                    #                    #                    #                    #                    #   
   #                                                                                   #                    #                    #                    #   
   #                                                                                   #                    #                    #                    #   
   #                                                                                   #                    #                    #                    #   
   #                                                                                   #                    #                    #                    #   
   #                                                                                   #                    #                    #                    #   
   #                                                                                   #                    #                    #                    #   
   #                                                                                   #                    #                    #                    #   
   #                    #                    #                    #                                                                                   #   
   #                    #                    #                    #                                                                                   #   
   #                    #                    #                    #                                                                                   #   
   #                    #                    #                    #                                                                                   #   
   #                    #                    #                    #                                                                                   #   
   #                    #                    #                    #                                                                                   #   
   #                    #                    #                    #                                                                                   #   
   #                    #                    #                    #                    #                                         #                    #   
   #                    #                    #                    #                    #                                         #                    #   
   #                    #                    #                    #                    #                                         #                    #   
   #          ##############       ####################################################################################       ##############          #   
   #                    #                    #                    #                    #                                         #                    #   
   #                    #                    #                    #                    #                                         #                    #   
   #                    #                    #                    #                    #                                         #                    #   
   #                    #                                         #                    #                                         #                    #   
   #                    #                                         #                    #                                         #                    #   
   #                    #                                         #                    #                                         #                    #   
   #                    #                                         #                    #                                         #                    #   
   #                    #                                         #                    #                                         #                    #   
   #                    #                                         #                    #                                         #                    #   
   #                    #                                         #                    #                                         #                    #   
   #                    #                    #                    #                    #                    #                    #                    #   
   #                    #                    #                    #                    #                    #                    #                    #   
   #                    #                    #                    #                    #                    #                    #                    #   
   #                    #                    #                    #                    #                    #                    #                    #   
   #                    #                    #                    #                    #                    #                    #                    #   
   #                    #                    #                    #                    #                    #                    #                    #   
   #                    #                    #                    #                    #                    #                    #                    #   
   #                    #                    #                    #                    #                    #                    #                    #   
   #                    #                    #                    #                    #                    #                    #                    #   
   #                    #                    #                    #                    #                    #                    #                    #   
##############          #          ###################################       #############################################################################
   #                    #                    #                    #                    #                    #                    #                    #   
   #                    #                    #                    #                    #                    #                    #                    #   
   #                    #                    #                    #                    #                    #                    #                    #   
   #                    #                    #                    #                                                                                   #   
   #                    #                    #                    #                                                                                   #   
   #                    #                    #                    #                                                                                   #   
   #                    #                    #                    #                                                                                   #   
   #                    #                    #                    #                                                                                   #   
   #                    #                    #                    #                                                                                   #   
   #                    #                    #                    #                                                                                   #   
   #                    #                                                              #                    #                    #                    #   
   #                    #                                                              #                    #                    #                    #   
   #                    #                                                              #                    #                    #                    #   
   #                    #                                                              #                    #                    #                    #   
   #                    #                                                              #                    #                    #                    #   
   #                    #                                                              #                    #                    #                    #   
   #                    #                                                              #                    #                    #                    #   
   #                    #                                                              #                    #                    #                    #   
   #                    #                                                              #                    #                    #                    #   
   #                    #                                                              #                    #                    #                    #   
##########################################################################################################################################################
   #                    #                                                              #                    #                    #                    #   
   #                    #                                                              #                    #                    #                    #   
   #                    #                                                              #                    #                    #                    #   