################
#@#    #       #
# # #          #
# # #  #       #
# # #  #       #
#   #  #       #
# # ######## ###
# # #          #
# # # ##########
# # #    #  #  #
# # #    #     #
# # #       #  #
# # #    #  #  #
# # #    #  #  #
# # #    #  #  #
################