################
#@        #  # #
#### ######    #
#         #  # #
#            # #
#         #  # #
#         #  # #
#         #  # #
#         #  # #
#         #  # #
######### #### #
#            # #
######### #### #
#            # #
#            # #
################