################
#@ # # #  # #  #
#  # # #  # #  #
#      #  # #  #
#  # # #  # #  #
#  # #    # #  #
#  # # #  #    #
#  # # #    #  #
#  # # #  # #  #
#  # # ## ###  #
#  # # #  # #  #
#  # # #    #  #
#  # # #  # ## #
#  # # #  # #  #
#  # # #  # #  #
################