################
#@# # #        #
# # # ######## #
#   # #        #
# # #          #
# # # #        #
# # # ### ######
# # # #     #  #
# # # #     ## #
# # # ##### #  #
# #   #     #  #
# # # #     #  #
# # # #     #  #
# # # #     #  #
# # # #        #
################