################
#@          #  #
#      #       #
#      ## ### ##
#      #    #  #
#      #    ## #
#      #    #  #
#      #    #  #
### ####    #  #
#      #    #  #
########## ##  #
#      #    #  #
#           #  #
###### #### #  #
#      #    #  #
################