################
#@      # #    #
#       # # #  #
####### # # #  #
#   #     # #  #
#   #   # # #  #
#       #   #  #
#   #   # # #  #
#   #   # # #  #
############# ##
#              #
## #############
#              #
######## #######
#              #
################