   #                                         #                    #                                         #                    #                    #   
   #                                         #                    #                                         #                    #                    #   
   #                                         #                    #                                         #                    #                    #   
##########################################################################################################################################################
   #                                         #                    #                                         #                    #                    #   
   #                                         #                    #                                         #                    #                    #   
   #                                         #                    #                                         #                    #                    #   
   #                                         #                    #                                         #                    #                    #   
   #                                         #                    #                                         #                    #                    #   
   #                                         #                    #                                         #                    #                    #   
   #      @                                  #                    #                                         #                    #                    #   
   #                                         #                    #                                         #                    #                    #   
   #                                         #                    #                                         #                    #                    #   
   #                                         #                    #                                         #                    #                    #   
   #                    #                                                              #                    #                                         #   
   #                    #                                                              #                    #                                         #   
   #                    #                                                              #                    #                                         #   
   #                    #                                                              #                    #                                         #   
   #                    #                                                              #                    #                                         #   
   #                    #                                                              #                    #                                         #   
   #                    #                                                              #                    #                                         #   
   #                    #                                         #                    #                    #                                         #   
   #                    #                                         #                    #                    #                                         #   
   #                    #                                         #                    #                    #                                         #   
##############          #          ###############################################################       ##############       ############################
   #                    #                                         #                    #                    #                                         #   
   #                    #                                         #                    #                    #                                         #   
   #                    #                                         #                    #                    #                                         #   
   #                    #                                         #                    #                                                              #   
   #                    #                                         #                    #                                                              #   
   #                    #                                         #                    #                                                              #   
   #                    #                                         #                    #                                                              #   
   #                    #                                         #                    #                                                              #   
   #                    #                                         #                    #                                                              #   
   #                    #                                         #                    #                                                              #   
   #                    #                    #                    #                    #                    #                    #                    #   
   #                    #                    #                    #                    #                    #                    #                    #   
   #                    #                    #                    #                    #                    #                    #                    #   
   #                    #                    #                    #                    #                    #                    #                    #   
   #                    #                    #                    #                    #                    #                    #                    #   
   #                    #                    #                    #                    #                    #                    #                    #   
   #                    #                    #                    #                    #                    #                    #                    #   
   #                    #                    #                    #                    #                    #                    #                    #   
   #                    #                    #                    #                    #                    #                    #                    #   
   #                    #                    #                    #                    #                    #                    #                    #   
##############       ############################       #####################       ##############          #          ##############       ##############
   #                    #                    #                    #                    #                    #                    #                    #   
   #                    #                    #                    #                    #                    #                    #                    #   
   #                    #                    #                    #                    #                    #                    #                    #   
   #                                         #                    #                    #                    #                    #                    #   
   #                                         #                    #                    #                    #                    #                    #   
   #                                         #                    #                    #                    #                    #                    #   
   #                                         #                    #                    #                    #                    #                    #   
   #                                         #                    #                    #                    #                    #                    #   
   #                                         #                    #                    #                    #                    #                    #   
   #                                         #                    #                    #                    #                    #                    #   
   #                    #                    #                                         #                    #                    #                    #   
   #                    #                    #                                         #                    #                    #                    #   
   #                    #                    #                                         #                    #                    #                    #   
   #                    #                    #                                         #                    #                    #                    #   
   #                    #                    #                                         #                    #                    #                    #   
   #                    #                    #                                         #                    #                    #                    #   
   #                    #                    #                                         #                    #                    #                    #   
   #                    #                    #                    #                    #                    #                    #                    #   
   #                    #                    #                    #                    #                    #                    #                    #   
   #                    #                    #                    #                    #                    #                    #                    #   
##############       ############################       ##########################################       ###################################          #   
   #                    #                    #                    #                    #                    #                    #                    #   
   #                    #                    #                    #                    #                    #                    #                    #   
   #                    #                    #                    #                    #                    #                    #                    #   
   #                    #                    #                    #                    #                                         #                    #   
   #                    #                    #                    #                    #                                         #                    #   
   #                    #                    #                    #                    #                                         #                    #   
   #                    #                    #                    #                    #                                         #                    #   
   #                    #                    #                    #                    #                                         #                    #   
   #                    #                    #                    #                    #                                         #                    #   
   #                    #                    #                    #                    #                                         #                    #   
   #                    #                                         #                                         #                    #                    #   
   #                    #                                         #                                         #                    #                    #   
   #                    #                                         #                                         #                    #                    #   
   #                    #                                         #                                         #                    #                    #   
   #                    #                                         #                                         #                    #                    #   
   #                    #                                         #                                         #                    #                    #   
   #                    #                                         #                                         #                    #                    #   
   #                    #                                         #                    #                    #                    #                    #   
   #                    #                                         #                    #                    #                    #                    #   
   #                    #                                         #                    #                    #                    #                    #   
   #          ##########################################       ############################       ########################################################
   #                    #                                         #                    #                    #                    #                    #   
   #                    #                                         #                    #                    #                    #                    #   
   #                    #                                         #                    #                    #                    #                    #   
   #                    #                                                              #                                         #                    #   
   #                    #                                                              #                                         #                    #   
   #                    #                                                              #                                         #                    #   
   #                    #                                                              #                                         #                    #   
   #                    #                                                              #                                         #                    #   
   #                    #                                                              #                                         #                    #   
   #                    #                                                              #                                         #                    #   
   #                    #                    #                    #                    #                    #                                         #   
   #                    #                    #                    #                    #                    #                                         #   
   #                    #                    #                    #                    #                    #                                         #   
   #                    #                    #                    #                    #                    #                                         #   
   #                    #                    #                    #                    #                    #                                         #   
   #                    #                    #                    #                    #                    #                                         #   
   #                    #                    #                    #                    #                    #                                         #   
   #                    #                    #                    #                    #                    #                    #                    #   
   #                    #                    #                    #                    #                    #                    #                    #   
   #                    #                    #                    #                    #                    #                    #                    #   
############################       ###############################################################       ############################       ##############
   #                    #                    #                    #                    #                    #                    #                    #   
   #                    #                    #                    #                    #                    #                    #                    #   
   #                    #                    #                    #                    #                    #                    #                    #   
   #                    #                    #                    #                    #                    #                    #                    #   
   #                    #                    #                    #                    #                    #                    #                    #   
   #                    #                    #                    #                    #                    #                    #                    #   
   #                    #                    #                    #                    #                    #                    #                    #   
   #                    #                    #                    #                    #                    #                    #                    #   
   #                    #                    #                    #                    #                    #                    #                    #   
   #                    #                    #                    #                    #                    #                    #                    #   
   #                                                              #                                                              #                    #   
   #                                                              #                                                              #                    #   
   #                                                              #                                                              #                    #   
   #                                                              #                                                              #                    #   
   #                                                              #                                                              #                    #   
   #                                                              #                                                              #                    #   
   #                                                              #                                                              #                    #   
   #                    #                                         #                    #                                         #                    #   
   #                    #                                         #                    #                                         #                    #   
   #                    #                                         #                    #                                         #                    #   
   #          ###################################       #############################################################################       ##############
   #                    #                                         #                    #                                         #                    #   
   #                    #                                         #                    #                                         #                    #   
   #                    #                                         #                    #                                         #                    #   
   #                    #                                         #                    #                                         #                    #   
   #                    #                                         #                    #                                         #                    #   
   #                    #                                         #                    #                                         #                    #   
   #                    #                                         #                    #                                         #                    #   
   #                    #                                         #                    #                                         #                    #   
   #                    #                                         #                    #                                         #                    #   
   #                    #                                         #                    #                                         #                    #   
   #                    #                    #                    #                                         #                                         #   
   #                    #                    #                    #                                         #                                         #   
   #                    #                    #                    #                                         #                                         #   
   #                    #                    #                    #                                         #                                         #   
   #                    #                    #                    #                                         #                                         #   
   #                    #                    #                    #                                         #                                         #   
   #                    #                    #                    #                                         #                                         #   
   #                    #                    #                    #                                         #                                         #   
   #                    #                    #                    #                                         #                                         #   
   #                    #                    #                    #                                         #                                         #   
##########################################################################################################################################################
   #                    #                    #                    #                                         #                                         #   
   #                    #                    #                    #                                         #                                         #   
   #                    #                    #                    #                                         #                                         #   