################
#@  # #    # # #
#   #   #  # # #
## ## # #  #   #
#   # # #  # # #
#   # # #  # # #
#   # # #  # # #
#   # # #  # # #
#   # # #  # # #
#   # # #  # # #
#     # #  # # #
#   # # #  # # #
#   # # #    # #
#   # # #  # # #
#   # # #  # # #
################