################
#@  #     #  # #
#   #     #    #
## ##     #  # #
#            # #
#   #     #  # #
#   #     #  # #
#   #     #  # #
#   #     #  # #
#   #     #  # #
#   #     #  # #
#   #     #  # #
#   #     #  # #
#   ######## ###
#   #          #
################