################
#@             #
#              #
##### ##########
#         # #  #
#              #
#### ###########
# #            #
# ## ###########
#              #
# #            #
######### ######
#              #
###### #########
#              #
################