################
#@#  # #  #    #
# #  # #       #
# #  # #  #### #
#    # #  #    #
# #  #    #### #
# #    #  #    #
# #  # #  ## ###
# #  # #  #    #
# #  # #  # ####
######## ##  # #
#         #  # #
#         #  # #
### #######    #
#         #  # #
################