################
#@          #  #
#         # #  #
######## ## #  #
#         # #  #
#         #    #
############# ##
#   #  #       #
#   #          #
#   #  # #######
#      #       #
########## #####
#    #         #
# #            #
# #  #         #
################