################
#@ #         # #
#  #     #   # #
#  #     #   # #
#  # #####   # #
#  #     #     #
#  ######## ####
#              #
#  ########## ##
#  #           #
#  #           #
#  ###### ######
#  #           #
#  #           #
#  #           #
################