################
#@# # #        #
# #   ####### ##
# # # #        #
# # # #        #
# # # ## #######
# # # #        #
# # # #        #
# # # #        #
# # # #        #
#   # #        #
# # # ### ######
# # # #        #
# # #          #
# # # #        #
################