################
#@   #         #
#    ##### #####
### ##         #
#    ##### #####
# #  #         #
### ###### #####
#           #  #
# #  #      #  #
# #  #      #  #
# #  #         #
# ## #      #  #
# #  #      #  #
# #  ######## ##
# #  #         #
################