################
#@             #
#  #           #
##### ##########
# #            #
# #            #
# ######## #####
# #            #
#              #
# #            #
# #            #
# #            #
######### ######
#              #
#   #          #
################