################
#@         # # #
######## ### # #
#              #
####### ########
#              #
#              #
## #############
#              #
########## #####
#              #
########## #####
#    # #     # #
#### # #   #   #
#          # # #
################