################
#@ #      #    #
#         #    #
#  #           #
############ ###
#              #
## #############
#              #
#              #
### ############
#              #
#              #
########## #####
#              #
#              #
################