################
#@             #
########## #####
#              #
# ##############
#              #
############## #
#              #
######## #######
#    #       # #
#              #
#    #       # #
#    #       # #
#    #       # #
#    #       # #
################