################
#@          #  #
#           #  #
#           #  #
#              #
#           #  #
##### ##########
#              #
####### ########
#              #
#              #
############# ##
#              #
######## #######
#              #
################