################
#@   #         #
#              #
########### ####
#              #
########### ####
#         #    #
#         #    #
#              #
#         #    #
############ ###
#              #
############## #
#              #
#              #
################