################
#@  # # #      #
# #   # # ######
# # # #        #
# # # # #      #
# # # # #      #
### # # ## #####
#   # # #      #
#   #   #  #   #
#   # # #  #   #
## ## # #  #   #
#   # #### #####
#   # # #      #
#   #   ### ####
#   # # #      #
################