################
#@       #     #
#          ## ##
#        # #   #
##### ##########
#              #
#              #
############ ###
#              #
###### #########
#              #
########## #####
#            # #
#            # #
#              #
################