################
#@             #
######## #######
#              #
## #############
#          #   #
#          #   #
#          #   #
#          #   #
#              #
#          #   #
####### ########
#              #
########### ####
#              #
################