################
#@       #     #
#              #
#        #     #
########### ####
#              #
############## #
#              #
####### ########
#              #
#              #
#              #
#              #
## #############
#              #
################