   #                    #                                         #                    #                    #                                         #   
   #                    #                                         #                    #                    #                                         #   
   #                    #                                         #                    #                    #                                         #   
##########################################################################################################################################################
   #                    #                                         #                    #                    #                                         #   
   #                    #                                         #                    #                    #                                         #   
   #                    #                                         #                    #                    #                                         #   
   #                    #                                         #                    #                    #                                         #   
   #                    #                                         #                    #                    #                                         #   
   #                    #                                         #                    #                    #                                         #   
   #      @             #                                         #                    #                    #                                         #   
   #                    #                                         #                    #                    #                                         #   
   #                    #                                         #                    #                    #                                         #   
   #                    #                                         #                    #                    #                                         #   
   #                                         #                                                              #                    #                    #   
   #                                         #                                                              #                    #                    #   
   #                                         #                                                              #                    #                    #   
   #                                         #                                                              #                    #                    #   
   #                                         #                                                              #                    #                    #   
   #                                         #                                                              #                    #                    #   
   #                                         #                                                              #                    #                    #   
   #                    #                    #                    #                                         #                    #                    #   
   #                    #                    #                    #                                         #                    #                    #   
   #                    #                    #                    #                                         #                    #                    #   
##############       ##############       ############################       ##########################################          #          ##############
   #                    #                    #                    #                                         #                    #                    #   
   #                    #                    #                    #                                         #                    #                    #   
   #                    #                    #                    #                                         #                    #                    #   
   #                    #                                         #                                         #                    #                    #   
   #                    #                                         #                                         #                    #                    #   
   #                    #                                         #                                         #                    #                    #   
   #                    #                                         #                                         #                    #                    #   
   #                    #                                         #                                         #                    #                    #   
   #                    #                                         #                                         #                    #                    #   
   #                    #                                         #                                         #                    #                    #   
   #                    #                    #                    #                    #                    #                    #                    #   
   #                    #                    #                    #                    #                    #                    #                    #   
   #                    #                    #                    #                    #                    #                    #                    #   
   #                    #                    #                    #                    #                    #                    #                    #   
   #                    #                    #                    #                    #                    #                    #                    #   
   #                    #                    #                    #                    #                    #                    #                    #   
   #                    #                    #                    #                    #                    #                    #                    #   
   #                    #                    #                    #                    #                    #                    #                    #   
   #                    #                    #                    #                    #                    #                    #                    #   
   #                    #                    #                    #                    #                    #                    #                    #   
   #          #######################################################################################################################       ##############
   #                    #                    #                    #                    #                    #                    #                    #   
   #                    #                    #                    #                    #                    #                    #                    #   
   #                    #                    #                    #                    #                    #                    #                    #   
   #                    #                    #                                         #                                         #                    #   
   #                    #                    #                                         #                                         #                    #   
   #                    #                    #                                         #                                         #                    #   
   #                    #                    #                                         #                                         #                    #   
   #                    #                    #                                         #                                         #                    #   
   #                    #                    #                                         #                                         #                    #   
   #                    #                    #                                         #                                         #                    #   
   #                                                              #                                         #                                         #   
   #                                                              #                                         #                                         #   
   #                                                              #                                         #                                         #   
   #                                                              #                                         #                                         #   
   #                                                              #                                         #                                         #   
   #                                                              #                                         #                                         #   
   #                                                              #                                         #                                         #   
   #                    #                                         #                    #                    #                    #                    #   
   #                    #                                         #                    #                    #                    #                    #   
   #                    #                                         #                    #                    #                    #                    #   
##############       ############################       #####################          #          #####################          #          ##############
   #                    #                                         #                    #                    #                    #                    #   
   #                    #                                         #                    #                    #                    #                    #   
   #                    #                                         #                    #                    #                    #                    #   
   #                    #                                         #                    #                    #                    #                    #   
   #                    #                                         #                    #                    #                    #                    #   
   #                    #                                         #                    #                    #                    #                    #   
   #                    #                                         #                    #                    #                    #                    #   
   #                    #                                         #                    #                    #                    #                    #   
   #                    #                                         #                    #                    #                    #                    #   
   #                    #                                         #                    #                    #                    #                    #   
   #                    #                    #                    #                    #                    #                    #                    #   
   #                    #                    #                    #                    #                    #                    #                    #   
   #                    #                    #                    #                    #                    #                    #                    #   
   #                    #                    #                    #                    #                    #                    #                    #   
   #                    #                    #                    #                    #                    #                    #                    #   
   #                    #                    #                    #                    #                    #                    #                    #   
   #                    #                    #                    #                    #                    #                    #                    #   
   #                    #                    #                    #                    #                    #                    #                    #   
   #                    #                    #                    #                    #                    #                    #                    #   
   #                    #                    #                    #                    #                    #                    #                    #   
   #          #####################          #          #####################       ###################################       ############################
   #                    #                    #                    #                    #                    #                    #                    #   
   #                    #                    #                    #                    #                    #                    #                    #   
   #                    #                    #                    #                    #                    #                    #                    #   
   #                    #                    #                    #                    #                    #                    #                    #   
   #                    #                    #                    #                    #                    #                    #                    #   
   #                    #                    #                    #                    #                    #                    #                    #   
   #                    #                    #                    #                    #                    #                    #                    #   
   #                    #                    #                    #                    #                    #                    #                    #   
   #                    #                    #                    #                    #                    #                    #                    #   
   #                    #                    #                    #                    #                    #                    #                    #   
   #                    #                    #                    #                                         #                                         #   
   #                    #                    #                    #                                         #                                         #   
   #                    #                    #                    #                                         #                                         #   
   #                    #                    #                    #                                         #                                         #   
   #                    #                    #                    #                                         #                                         #   
   #                    #                    #                    #                                         #                                         #   
   #                    #                    #                    #                                         #                                         #   
   #                    #                    #                    #                    #                    #                    #                    #   
   #                    #                    #                    #                    #                    #                    #                    #   
   #                    #                    #                    #                    #                    #                    #                    #   
##############       #################################################       ##########################################          #          ##############
   #                    #                    #                    #                    #                    #                    #                    #   
   #                    #                    #                    #                    #                    #                    #                    #   
   #                    #                    #                    #                    #                    #                    #                    #   
   #                                                              #                    #                    #                    #                    #   
   #                                                              #                    #                    #                    #                    #   
   #                                                              #                    #                    #                    #                    #   
   #                                                              #                    #                    #                    #                    #   
   #                                                              #                    #                    #                    #                    #   
   #                                                              #                    #                    #                    #                    #   
   #                                                              #                    #                    #                    #                    #   
   #                    #                    #                    #                                         #                    #                    #   
   #                    #                    #                    #                                         #                    #                    #   
   #                    #                    #                    #                                         #                    #                    #   
   #                    #                    #                    #                                         #                    #                    #   
   #                    #                    #                    #                                         #                    #                    #   
   #                    #                    #                    #                                         #                    #                    #   
   #                    #                    #                    #                                         #                    #                    #   
   #                    #                    #                    #                    #                    #                    #                    #   
   #                    #                    #                    #                    #                    #                    #                    #   
   #                    #                    #                    #                    #                    #                    #                    #   
   #          ########################################################       ##########################################          #          ##############
   #                    #                    #                    #                    #                    #                    #                    #   
   #                    #                    #                    #                    #                    #                    #                    #   
   #                    #                    #                    #                    #                    #                    #                    #   
   #                    #                    #                    #                    #                    #                    #                    #   
   #                    #                    #                    #                    #                    #                    #                    #   
   #                    #                    #                    #                    #                    #                    #                    #   
   #                    #                    #                    #                    #                    #                    #                    #   
   #                    #                    #                    #                    #                    #                    #                    #   
   #                    #                    #                    #                    #                    #                    #                    #   
   #                    #                    #                    #                    #                    #                    #                    #   
   #                    #                                                                                   #                    #                    #   
   #                    #                                                                                   #                    #                    #   
   #                    #                                                                                   #                    #                    #   
   #                    #                                                                                   #                    #                    #   
   #                    #                                                                                   #                    #                    #   
   #                    #                                                                                   #                    #                    #   
   #                    #                                                                                   #                    #                    #   
   #                    #                                                                                   #                    #                    #   
   #                    #                                                                                   #                    #                    #   
   #                    #                                                                                   #                    #                    #   
##########################################################################################################################################################
   #                    #                                                                                   #                    #                    #   
   #                    #                                                                                   #                    #                    #   
   #                    #                                                                                   #                    #                    #   