################
#@#     # # #  #
# #       # #  #
# ##### # # #  #
# #     #      #
# #     # # #  #
# #     # # #  #
# #     # # #  #
# #     # # #  #
# #     # # #  #
# #     # # #  #
# #     # # #  #
# #     # # #  #
#       # # #  #
# #     # # #  #
################