################
#@# #  # #  #  #
#   #  # #  #  #
# # #  # #  #  #
# # #  #    #  #
# # #  # #  #  #
### #    #     #
#   #  # #  #  #
## ##### #  #  #
#   #    #  #  #
#   #    #  #  #
#   #    #  #  #
#   ### ##  #  #
#   #    ##### #
#        #     #
################