################
#@#   #  # #   #
# #      # #   #
#     #  #     #
# #   #  # #   #
# # ###  # #   #
# # # # ## #   #
# # # #    #   #
# # # #  # ### #
# # # #  # #   #
# # # ## # #   #
# # # #  # #   #
# #   #  # #   #
# # # #  # #   #
# # # #  # #   #
################