################
#@             #
#              #
############## #
#              #
#              #
## #############
#              #
#              #
######### ######
#              #
#### ###########
#    #       # #
## ###       # #
#              #
################