################
#@             #
## ######### ###
#   #          #
#   ######## ###
### #          #
#   #          #
##### ##########
#  #   #       #
#  #   #     # #
#  #   ##### ###
#      #       #
#  #   #       #
#  #   ## ######
#  #           #
################