################
#@# # # #   #  #
# # # # #   #  #
# # # # #   #  #
# #   # #   #  #
#   # # #   #  #
# # # # #      #
# # #       #  #
# # # # #   #  #
# # # # #   #  #
######### ######
#              #
#              #
### ############
#              #
################