################
#@          #  #
# ########  #  #
#        #  #  #
#        #     #
#        #  #  #
###### #########
#              #
########## #####
#       #      #
#           #  #
#       #   #  #
#### ####   #  #
#       #   #  #
#       #   #  #
################