################
#@      #  # # #
#### ####  # # #
#       ## # # #
#          # # #
#       #  # # #
#       #    # #
### #####  #   #
#       #  # # #
#       #  # # #
### ###### # # #
#       #  # # #
#       #  # # #
####### #  # # #
#       #  # # #
################