################
#@# #          #
# # #  ####### #
# #    #       #
# # #  #       #
# # #  #       #
# # #  #       #
#   #  #       #
# # #  #       #
######## #######
# #            #
#   #          #
# ######## #####
# #            #
# #            #
################