################
#@  #  # #  #  #
# # #  # #  #  #
# #    # #  #  #
# # #    #  #  #
# # #  #    #  #
# # #  # #     #
# # #  # #  #  #
# # #  # ## #  #
# # #  # #  #  #
# # #  # #  #  #
# # #  # #  #  #
# # #  # #  #  #
# # #  # #  #  #
# # #  # #  #  #
################