################
#@    #        #
## ####   #    #
#         # ####
##### ## ##    #
#     #   #    #
########### ####
#  #   # #     #
#  #   # #  #  #
#  #   # #### ##
#  #   # # #   #
#  #   #   #   #
# ##   # # #   #
#        #     #
#  #   # # #   #
################