################
#@  #  #     # #
#   #        # #
#   #  #     # #
#   #  #       #
#      #     # #
### ####     # #
#      #### ## #
#    # #     # #
########### ####
#       #      #
#            # #
#       #    # #
###### ####### #
#            # #
################