   #                                         #                                                                                                        #   
   #                                         #                                                                                                        #   
   #                                         #                                                                                                        #   
##########################################################################################################################################################
   #                                         #                                                                                                        #   
   #                                         #                                                                                                        #   
   #                                         #                                                                                                        #   
   #                                         #                                                                                                        #   
   #                                         #                                                                                                        #   
   #                                         #                                                                                                        #   
   #      @                                  #                                                                                                        #   
   #                                         #                                                                                                        #   
   #                                         #                                                                                                        #   
   #                                         #                                                                                                        #   
   #                    #                                         #                    #                    #                    #                    #   
   #                    #                                         #                    #                    #                    #                    #   
   #                    #                                         #                    #                    #                    #                    #   
   #                    #                                         #                    #                    #                    #                    #   
   #                    #                                         #                    #                    #                    #                    #   
   #                    #                                         #                    #                    #                    #                    #   
   #                    #                                         #                    #                    #                    #                    #   
   #                    #                    #                    #                    #                    #                    #                    #   
   #                    #                    #                    #                    #                    #                    #                    #   
   #                    #                    #                    #                    #                    #                    #                    #   
   #          #####################       #############################################################################       ############################
   #                    #                    #                    #                    #                    #                    #                    #   
   #                    #                    #                    #                    #                    #                    #                    #   
   #                    #                    #                    #                    #                    #                    #                    #   
   #                    #                    #                                         #                    #                    #                    #   
   #                    #                    #                                         #                    #                    #                    #   
   #                    #                    #                                         #                    #                    #                    #   
   #                    #                    #                                         #                    #                    #                    #   
   #                    #                    #                                         #                    #                    #                    #   
   #                    #                    #                                         #                    #                    #                    #   
   #                    #                    #                                         #                    #                    #                    #   
   #                    #                                         #                                         #                                         #   
   #                    #                                         #                                         #                                         #   
   #                    #                                         #                                         #                                         #   
   #                    #                                         #                                         #                                         #   
   #                    #                                         #                                         #                                         #   
   #                    #                                         #                                         #                                         #   
   #                    #                                         #                                         #                                         #   
   #                    #                    #                    #                                         #                                         #   
   #                    #                    #                    #                                         #                                         #   
   #                    #                    #                    #                                         #                                         #   
   #          ###############################################################       ######################################################################
   #                    #                    #                    #                                         #                                         #   
   #                    #                    #                    #                                         #                                         #   
   #                    #                    #                    #                                         #                                         #   
   #                    #                    #                    #                                                                                   #   
   #                    #                    #                    #                                                                                   #   
   #                    #                    #                    #                                                                                   #   
   #                    #                    #                    #                                                                                   #   
   #                    #                    #                    #                                                                                   #   
   #                    #                    #                    #                                                                                   #   
   #                    #                    #                    #                                                                                   #   
   #                                                              #                    #                    #                    #                    #   
   #                                                              #                    #                    #                    #                    #   
   #                                                              #                    #                    #                    #                    #   
   #                                                              #                    #                    #                    #                    #   
   #                                                              #                    #                    #                    #                    #   
   #                                                              #                    #                    #                    #                    #   
   #                                                              #                    #                    #                    #                    #   
   #                    #                    #                    #                    #                    #                    #                    #   
   #                    #                    #                    #                    #                    #                    #                    #   
   #                    #                    #                    #                    #                    #                    #                    #   
##############       ######################################################################       ########################################################
   #                    #                    #                    #                    #                    #                    #                    #   
   #                    #                    #                    #                    #                    #                    #                    #   
   #                    #                    #                    #                    #                    #                    #                    #   
   #                    #                    #                                         #                    #                    #                    #   
   #                    #                    #                                         #                    #                    #                    #   
   #                    #                    #                                         #                    #                    #                    #   
   #                    #                    #                                         #                    #                    #                    #   
   #                    #                    #                                         #                    #                    #                    #   
   #                    #                    #                                         #                    #                    #                    #   
   #                    #                    #                                         #                    #                    #                    #   
   #                                         #                    #                    #                    #                                         #   
   #                                         #                    #                    #                    #                                         #   
   #                                         #                    #                    #                    #                                         #   
   #                                         #                    #                    #                    #                                         #   
   #                                         #                    #                    #                    #                                         #   
   #                                         #                    #                    #                    #                                         #   
   #                                         #                    #                    #                    #                                         #   
   #                                         #                    #                    #                    #                    #                    #   
   #                                         #                    #                    #                    #                    #                    #   
   #                                         #                    #                    #                    #                    #                    #   
##############       ###################################       #############################################################################          #   
   #                                         #                    #                    #                    #                    #                    #   
   #                                         #                    #                    #                    #                    #                    #   
   #                                         #                    #                    #                    #                    #                    #   
   #                                         #                    #                    #                    #                    #                    #   
   #                                         #                    #                    #                    #                    #                    #   
   #                                         #                    #                    #                    #                    #                    #   
   #                                         #                    #                    #                    #                    #                    #   
   #                                         #                    #                    #                    #                    #                    #   
   #                                         #                    #                    #                    #                    #                    #   
   #                                         #                    #                    #                    #                    #                    #   
   #                    #                    #                    #                                                              #                    #   
   #                    #                    #                    #                                                              #                    #   
   #                    #                    #                    #                                                              #                    #   
   #                    #                    #                    #                                                              #                    #   
   #                    #                    #                    #                                                              #                    #   
   #                    #                    #                    #                                                              #                    #   
   #                    #                    #                    #                                                              #                    #   
   #                    #                    #                    #                    #                                         #                    #   
   #                    #                    #                    #                    #                                         #                    #   
   #                    #                    #                    #                    #                                         #                    #   
###################################          #          #####################       #################################################       ##############
   #                    #                    #                    #                    #                                         #                    #   
   #                    #                    #                    #                    #                                         #                    #   
   #                    #                    #                    #                    #                                         #                    #   
   #                    #                    #                    #                    #                                                              #   
   #                    #                    #                    #                    #                                                              #   
   #                    #                    #                    #                    #                                                              #   
   #                    #                    #                    #                    #                                                              #   
   #                    #                    #                    #                    #                                                              #   
   #                    #                    #                    #                    #                                                              #   
   #                    #                    #                    #                    #                                                              #   
   #                    #                                                                                   #                    #                    #   
   #                    #                                                                                   #                    #                    #   
   #                    #                                                                                   #                    #                    #   
   #                    #                                                                                   #                    #                    #   
   #                    #                                                                                   #                    #                    #   
   #                    #                                                                                   #                    #                    #   
   #                    #                                                                                   #                    #                    #   
   #                    #                    #                    #                                         #                    #                    #   
   #                    #                    #                    #                                         #                    #                    #   
   #                    #                    #                    #                                         #                    #                    #   
##############       ##############          #          ##############       ###############################################################          #   
   #                    #                    #                    #                                         #                    #                    #   
   #                    #                    #                    #                                         #                    #                    #   
   #                    #                    #                    #                                         #                    #                    #   
   #                                         #                    #                                         #                                         #   
   #                                         #                    #                                         #                                         #   
   #                                         #                    #                                         #                                         #   
   #                                         #                    #                                         #                                         #   
   #                                         #                    #                                         #                                         #   
   #                                         #                    #                                         #                                         #   
   #                                         #                    #                                         #                                         #   
   #                    #                    #                    #                    #                    #                    #                    #   
   #                    #                    #                    #                    #                    #                    #                    #   
   #                    #                    #                    #                    #                    #                    #                    #   
   #                    #                    #                    #                    #                    #                    #                    #   
   #                    #                    #                    #                    #                    #                    #                    #   
   #                    #                    #                    #                    #                    #                    #                    #   
   #                    #                    #                    #                    #                    #                    #                    #   
   #                    #                    #                    #                    #                    #                    #                    #   
   #                    #                    #                    #                    #                    #                    #                    #   
   #                    #                    #                    #                    #                    #                    #                    #   
##########################################################################################################################################################
   #                    #                    #                    #                    #                    #                    #                    #   
   #                    #                    #                    #                    #                    #                    #                    #   
   #                    #                    #                    #                    #                    #                    #                    #   