################
#@      #      #
##### ######## #
#              #
#     # #      #
### ############
# #            #
# ##### ########
#              #
######## #######
#              #
#              #
###### #########
#              #
#              #
################