   #                    #                    #                    #                    #                    #                    #                    #   
   #                    #                    #                    #                    #                    #                    #                    #   
   #                    #                    #                    #                    #                    #                    #                    #   
##########################################################################################################################################################
   #                    #                    #                    #                    #                    #                    #                    #   
   #                    #                    #                    #                    #                    #                    #                    #   
   #                    #                    #                    #                    #                    #                    #                    #   
   #                    #                    #                    #                    #                    #                    #                    #   
   #                    #                    #                    #                    #                    #                    #                    #   
   #                    #                    #                    #                    #                    #                    #                    #   
   #      @             #                    #                    #                    #                    #                    #                    #   
   #                    #                    #                    #                    #                    #                    #                    #   
   #                    #                    #                    #                    #                    #                    #                    #   
   #                    #                    #                    #                    #                    #                    #                    #   
   #                                                                                                                             #                    #   
   #                                                                                                                             #                    #   
   #                                                                                                                             #                    #   
   #                                                                                                                             #                    #   
   #                                                                                                                             #                    #   
   #                                                                                                                             #                    #   
   #                                                                                                                             #                    #   
   #                    #                    #                    #                    #                                         #                    #   
   #                    #                    #                    #                    #                                         #                    #   
   #                    #                    #                    #                    #                                         #                    #   
   #          ##########################################       ##############       ##############       ############################       ##############
   #                    #                    #                    #                    #                                         #                    #   
   #                    #                    #                    #                    #                                         #                    #   
   #                    #                    #                    #                    #                                         #                    #   
   #                    #                    #                    #                    #                                         #                    #   
   #                    #                    #                    #                    #                                         #                    #   
   #                    #                    #                    #                    #                                         #                    #   
   #                    #                    #                    #                    #                                         #                    #   
   #                    #                    #                    #                    #                                         #                    #   
   #                    #                    #                    #                    #                                         #                    #   
   #                    #                    #                    #                    #                                         #                    #   
   #                                         #                    #                    #                    #                    #                    #   
   #                                         #                    #                    #                    #                    #                    #   
   #                                         #                    #                    #                    #                    #                    #   
   #                                         #                    #                    #                    #                    #                    #   
   #                                         #                    #                    #                    #                    #                    #   
   #                                         #                    #                    #                    #                    #                    #   
   #                                         #                    #                    #                    #                    #                    #   
   #                                         #                    #                    #                    #                    #                    #   
   #                                         #                    #                    #                    #                    #                    #   
   #                                         #                    #                    #                    #                    #                    #   
   #          ##########################################       ######################################################################       ##############
   #                                         #                    #                    #                    #                    #                    #   
   #                                         #                    #                    #                    #                    #                    #   
   #                                         #                    #                    #                    #                    #                    #   
   #                                         #                                                                                   #                    #   
   #                                         #                                                                                   #                    #   
   #                                         #                                                                                   #                    #   
   #                                         #                                                                                   #                    #   
   #                                         #                                                                                   #                    #   
   #                                         #                                                                                   #                    #   
   #                                         #                                                                                   #                    #   
   #                    #                    #                    #                    #                    #                                         #   
   #                    #                    #                    #                    #                    #                                         #   
   #                    #                    #                    #                    #                    #                                         #   
   #                    #                    #                    #                    #                    #                                         #   
   #                    #                    #                    #                    #                    #                                         #   
   #                    #                    #                    #                    #                    #                                         #   
   #                    #                    #                    #                    #                    #                                         #   
   #                    #                    #                    #                    #                    #                    #                    #   
   #                    #                    #                    #                    #                    #                    #                    #   
   #                    #                    #                    #                    #                    #                    #                    #   
############################       ###################################       #############################################################################
   #                    #                    #                    #                    #                    #                    #                    #   
   #                    #                    #                    #                    #                    #                    #                    #   
   #                    #                    #                    #                    #                    #                    #                    #   
   #                    #                                         #                    #                    #                    #                    #   
   #                    #                                         #                    #                    #                    #                    #   
   #                    #                                         #                    #                    #                    #                    #   
   #                    #                                         #                    #                    #                    #                    #   
   #                    #                                         #                    #                    #                    #                    #   
   #                    #                                         #                    #                    #                    #                    #   
   #                    #                                         #                    #                    #                    #                    #   
   #                                         #                    #                    #                    #                    #                    #   
   #                                         #                    #                    #                    #                    #                    #   
   #                                         #                    #                    #                    #                    #                    #   
   #                                         #                    #                    #                    #                    #                    #   
   #                                         #                    #                    #                    #                    #                    #   
   #                                         #                    #                    #                    #                    #                    #   
   #                                         #                    #                    #                    #                    #                    #   
   #                    #                    #                    #                    #                    #                    #                    #   
   #                    #                    #                    #                    #                    #                    #                    #   
   #                    #                    #                    #                    #                    #                    #                    #   
############################       ###############################################################          #          ##############       ##############
   #                    #                    #                    #                    #                    #                    #                    #   
   #                    #                    #                    #                    #                    #                    #                    #   
   #                    #                    #                    #                    #                    #                    #                    #   
   #                    #                                                              #                    #                    #                    #   
   #                    #                                                              #                    #                    #                    #   
   #                    #                                                              #                    #                    #                    #   
   #                    #                                                              #                    #                    #                    #   
   #                    #                                                              #                    #                    #                    #   
   #                    #                                                              #                    #                    #                    #   
   #                    #                                                              #                    #                    #                    #   
   #                                         #                    #                                                                                   #   
   #                                         #                    #                                                                                   #   
   #                                         #                    #                                                                                   #   
   #                                         #                    #                                                                                   #   
   #                                         #                    #                                                                                   #   
   #                                         #                    #                                                                                   #   
   #                                         #                    #                                                                                   #   
   #                                         #                    #                    #                    #                    #                    #   
   #                                         #                    #                    #                    #                    #                    #   
   #                                         #                    #                    #                    #                    #                    #   
###################################       ############################       #####################       ##############       ##############          #   
   #                                         #                    #                    #                    #                    #                    #   
   #                                         #                    #                    #                    #                    #                    #   
   #                                         #                    #                    #                    #                    #                    #   
   #                                                              #                    #                    #                    #                    #   
   #                                                              #                    #                    #                    #                    #   
   #                                                              #                    #                    #                    #                    #   
   #                                                              #                    #                    #                    #                    #   
   #                                                              #                    #                    #                    #                    #   
   #                                                              #                    #                    #                    #                    #   
   #                                                              #                    #                    #                    #                    #   
   #                    #                    #                    #                    #                    #                    #                    #   
   #                    #                    #                    #                    #                    #                    #                    #   
   #                    #                    #                    #                    #                    #                    #                    #   
   #                    #                    #                    #                    #                    #                    #                    #   
   #                    #                    #                    #                    #                    #                    #                    #   
   #                    #                    #                    #                    #                    #                    #                    #   
   #                    #                    #                    #                    #                    #                    #                    #   
   #                    #                    #                    #                    #                    #                    #                    #   
   #                    #                    #                    #                    #                    #                    #                    #   
   #                    #                    #                    #                    #                    #                    #                    #   
############################       ##########################################       ########################################################          #   
   #                    #                    #                    #                    #                    #                    #                    #   
   #                    #                    #                    #                    #                    #                    #                    #   
   #                    #                    #                    #                    #                    #                    #                    #   
   #                    #                    #                    #                                                              #                    #   
   #                    #                    #                    #                                                              #                    #   
   #                    #                    #                    #                                                              #                    #   
   #                    #                    #                    #                                                              #                    #   
   #                    #                    #                    #                                                              #                    #   
   #                    #                    #                    #                                                              #                    #   
   #                    #                    #                    #                                                              #                    #   
   #                                         #                                         #                    #                    #                    #   
   #                                         #                                         #                    #                    #                    #   
   #                                         #                                         #                    #                    #                    #   
   #                                         #                                         #                    #                    #                    #   
   #                                         #                                         #                    #                    #                    #   
   #                                         #                                         #                    #                    #                    #   
   #                                         #                                         #                    #                    #                    #   
   #                                         #                                         #                    #                    #                    #   
   #                                         #                                         #                    #                    #                    #   
   #                                         #                                         #                    #                    #                    #   
##########################################################################################################################################################
   #                                         #                                         #                    #                    #                    #   
   #                                         #                                         #                    #                    #                    #   
   #                                         #                                         #                    #                    #                    #   