################
#@ #  #  # # # #
#  #  #  # # # #
#  #  #  # # # #
#  #  #  # #   #
#  #     # # # #
#  #  #  #   # #
#     #  # # # #
#  ## ## # ### #
#  #  #    #   #
#  ## #  # #   #
#  #  #  # #   #
#  #  #  # #   #
#  #  #  # ### #
#  #  #  # #   #
################