################
#@             #
########### ####
#         #    #
#         #    #
#              #
#         #    #
# ##############
#              #
########## #####
#   # #        #
# # # #        #
# # #          #
# # # ##### ####
# #   #        #
################