################
#@#            #
# #            #
# ## ###########
# #            #
# ### ##########
#      #       #
# #    #       #
# #    #       #
# #    #       #
# #            #
# #    #       #
# #### #########
# #            #
# #            #
################