################
#@   #    #  # #
## ###         #
#    ## ###  # #
# ####  # #  # #
#    #  # #  # #
#    #  # #  # #
#    #  # #  # #
#       # #  # #
#    #  # #  # #
#### #  # #  # #
#    #  # #  # #
## ###  # #  # #
#    #  # #  # #
#    #    #  # #
################