################
#@ #  #        #
#  #  #### #####
#              #
#  #  ###### ###
#  #  #    #   #
# ##  #    #   #
#  #  #        #
############ ###
#        # #   #
####### ##   # #
#          # # #
### ###### # # #
#        # # # #
#        # # # #
################