################
#@    #      # #
#     #      # #
#     #      # #
#            # #
#     #      # #
#     #        #
############## #
#              #
######### ######
#              #
#### ###########
#        #     #
#### ##        #
#     #  #     #
################