################
#@      #  #   #
#       #  #   #
#       #  #   #
#### ####  #   #
#       #  #   #
#       #  #   #
#       #  #   #
#       #  #   #
#              #
###### ##### ###
# #     #      #
#       # #    #
############ ###
#              #
################