################
#@             #
####### ########
#              #
##### ##########
#              #
### ############
#              #
##### ##########
#            # #
#            # #
#            # #
#              #
#            # #
#            # #
################