################
#@             #
# #            #
######### ######
#    #         #
## ###         #
#    #         #
# ####         #
#  # # #########
#  # #         #
#  # #         #
#    ######## ##
#  # #  #      #
#  #           #
#  # #  #      #
################