################
#@#    #       #
# #### #       #
# # #  #       #
# # #  #       #
# # #  #       #
# #    #       #
# # #  ###### ##
# # #  #       #
# # #  #       #
# # #  #       #
# # #          #
# # #  ####### #
# # #  #       #
#   #  #       #
################