################
#@      #      #
#  #  # #      #
#  #  # #      #
#  #  # #      #
#  #  # #      #
#  #  #        #
########### ####
#    #         #
#         #    #
#### ###########
#              #
#### ###########
#              #
# #            #
################