################
#@             #
# #  #       # #
####### ########
# #            #
# #         #  #
# #         # ##
# #         #  #
# # #########  #
# #         #  #
# #         #  #
# #         #  #
# #         #  #
# #         #  #
#           #  #
################