################
#@             #
# ##############
#          #   #
#          ## ##
#          #   #
#          #   #
#          #   #
# ########### ##
#              #
#          #   #
#          #   #
#          # ###
###### #####   #
#          #   #
################