################
#@    #  #     #
##### #  #     #
# #   #  #     #
# #   #  ##### #
# #   #        #
# #   #  #     #
#     #  #     #
# ## ### #     #
# #      #     #
# #   # ##     #
# #   #  #     #
# #   #  ### ###
# #   # ##     #
# #   #  #     #
################