   #                                         #                    #                    #                    #                    #                    #   
   #                                         #                    #                    #                    #                    #                    #   
   #                                         #                    #                    #                    #                    #                    #   
##########################################################################################################################################################
   #                                         #                    #                    #                    #                    #                    #   
   #                                         #                    #                    #                    #                    #                    #   
   #                                         #                    #                    #                    #                    #                    #   
   #                                         #                    #                    #                    #                    #                    #   
   #                                         #                    #                    #                    #                    #                    #   
   #                                         #                    #                    #                    #                    #                    #   
   #      @                                  #                    #                    #                    #                    #                    #   
   #                                         #                    #                    #                    #                    #                    #   
   #                                         #                    #                    #                    #                    #                    #   
   #                                         #                    #                    #                    #                    #                    #   
   #                    #                    #                    #                    #                                         #                    #   
   #                    #                    #                    #                    #                                         #                    #   
   #                    #                    #                    #                    #                                         #                    #   
   #                    #                    #                    #                    #                                         #                    #   
   #                    #                    #                    #                    #                                         #                    #   
   #                    #                    #                    #                    #                                         #                    #   
   #                    #                    #                    #                    #                                         #                    #   
   #                    #                    #                    #                    #                    #                    #                    #   
   #                    #                    #                    #                    #                    #                    #                    #   
   #                    #                    #                    #                    #                    #                    #                    #   
   #          ##############       ##############       ##############       ##############       ###################################       ##############
   #                    #                    #                    #                    #                    #                    #                    #   
   #                    #                    #                    #                    #                    #                    #                    #   
   #                    #                    #                    #                    #                    #                    #                    #   
   #                    #                    #                    #                                         #                    #                    #   
   #                    #                    #                    #                                         #                    #                    #   
   #                    #                    #                    #                                         #                    #                    #   
   #                    #                    #                    #                                         #                    #                    #   
   #                    #                    #                    #                                         #                    #                    #   
   #                    #                    #                    #                                         #                    #                    #   
   #                    #                    #                    #                                         #                    #                    #   
   #                    #                                                              #                                         #                    #   
   #                    #                                                              #                                         #                    #   
   #                    #                                                              #                                         #                    #   
   #                    #                                                              #                                         #                    #   
   #                    #                                                              #                                         #                    #   
   #                    #                                                              #                                         #                    #   
   #                    #                                                              #                                         #                    #   
   #                    #                    #                    #                    #                                         #                    #   
   #                    #                    #                    #                    #                                         #                    #   
   #                    #                    #                    #                    #                                         #                    #   
   #          ##########################################          #          ##############       ##########################################          #   
   #                    #                    #                    #                    #                                         #                    #   
   #                    #                    #                    #                    #                                         #                    #   
   #                    #                    #                    #                    #                                         #                    #   
   #                    #                    #                    #                    #                                                              #   
   #                    #                    #                    #                    #                                                              #   
   #                    #                    #                    #                    #                                                              #   
   #                    #                    #                    #                    #                                                              #   
   #                    #                    #                    #                    #                                                              #   
   #                    #                    #                    #                    #                                                              #   
   #                    #                    #                    #                    #                                                              #   
   #                                         #                    #                    #                    #                    #                    #   
   #                                         #                    #                    #                    #                    #                    #   
   #                                         #                    #                    #                    #                    #                    #   
   #                                         #                    #                    #                    #                    #                    #   
   #                                         #                    #                    #                    #                    #                    #   
   #                                         #                    #                    #                    #                    #                    #   
   #                                         #                    #                    #                    #                    #                    #   
   #                    #                    #                    #                    #                    #                    #                    #   
   #                    #                    #                    #                    #                    #                    #                    #   
   #                    #                    #                    #                    #                    #                    #                    #   
############################       ##############       ##############       ##########################################       ##############          #   
   #                    #                    #                    #                    #                    #                    #                    #   
   #                    #                    #                    #                    #                    #                    #                    #   
   #                    #                    #                    #                    #                    #                    #                    #   
   #                    #                    #                    #                    #                    #                    #                    #   
   #                    #                    #                    #                    #                    #                    #                    #   
   #                    #                    #                    #                    #                    #                    #                    #   
   #                    #                    #                    #                    #                    #                    #                    #   
   #                    #                    #                    #                    #                    #                    #                    #   
   #                    #                    #                    #                    #                    #                    #                    #   
   #                    #                    #                    #                    #                    #                    #                    #   
   #                                         #                    #                                         #                    #                    #   
   #                                         #                    #                                         #                    #                    #   
   #                                         #                    #                                         #                    #                    #   
   #                                         #                    #                                         #                    #                    #   
   #                                         #                    #                                         #                    #                    #   
   #                                         #                    #                                         #                    #                    #   
   #                                         #                    #                                         #                    #                    #   
   #                                         #                    #                                         #                    #                    #   
   #                                         #                    #                                         #                    #                    #   
   #                                         #                    #                                         #                    #                    #   
############################       ###################################       ###################################       #####################          #   
   #                                         #                    #                                         #                    #                    #   
   #                                         #                    #                                         #                    #                    #   
   #                                         #                    #                                         #                    #                    #   
   #                                         #                    #                                         #                    #                    #   
   #                                         #                    #                                         #                    #                    #   
   #                                         #                    #                                         #                    #                    #   
   #                                         #                    #                                         #                    #                    #   
   #                                         #                    #                                         #                    #                    #   
   #                                         #                    #                                         #                    #                    #   
   #                                         #                    #                                         #                    #                    #   
   #                    #                    #                    #                    #                    #                    #                    #   
   #                    #                    #                    #                    #                    #                    #                    #   
   #                    #                    #                    #                    #                    #                    #                    #   
   #                    #                    #                    #                    #                    #                    #                    #   
   #                    #                    #                    #                    #                    #                    #                    #   
   #                    #                    #                    #                    #                    #                    #                    #   
   #                    #                    #                    #                    #                    #                    #                    #   
   #                    #                    #                    #                    #                    #                    #                    #   
   #                    #                    #                    #                    #                    #                    #                    #   
   #                    #                    #                    #                    #                    #                    #                    #   
###################################          #          #####################          #          ########################################################
   #                    #                    #                    #                    #                    #                    #                    #   
   #                    #                    #                    #                    #                    #                    #                    #   
   #                    #                    #                    #                    #                    #                    #                    #   
   #                    #                    #                                         #                                         #                    #   
   #                    #                    #                                         #                                         #                    #   
   #                    #                    #                                         #                                         #                    #   
   #                    #                    #                                         #                                         #                    #   
   #                    #                    #                                         #                                         #                    #   
   #                    #                    #                                         #                                         #                    #   
   #                    #                    #                                         #                                         #                    #   
   #                                         #                    #                    #                    #                                         #   
   #                                         #                    #                    #                    #                                         #   
   #                                         #                    #                    #                    #                                         #   
   #                                         #                    #                    #                    #                                         #   
   #                                         #                    #                    #                    #                                         #   
   #                                         #                    #                    #                    #                                         #   
   #                                         #                    #                    #                    #                                         #   
   #                    #                    #                    #                    #                    #                                         #   
   #                    #                    #                    #                    #                    #                                         #   
   #                    #                    #                    #                    #                    #                                         #   
##############       ##############       #############################################################################       ############################
   #                    #                    #                    #                    #                    #                                         #   
   #                    #                    #                    #                    #                    #                                         #   
   #                    #                    #                    #                    #                    #                                         #   
   #                    #                                         #                    #                                                              #   
   #                    #                                         #                    #                                                              #   
   #                    #                                         #                    #                                                              #   
   #                    #                                         #                    #                                                              #   
   #                    #                                         #                    #                                                              #   
   #                    #                                         #                    #                                                              #   
   #                    #                                         #                    #                                                              #   
   #                    #                    #                                         #                    #                    #                    #   
   #                    #                    #                                         #                    #                    #                    #   
   #                    #                    #                                         #                    #                    #                    #   
   #                    #                    #                                         #                    #                    #                    #   
   #                    #                    #                                         #                    #                    #                    #   
   #                    #                    #                                         #                    #                    #                    #   
   #                    #                    #                                         #                    #                    #                    #   
   #                    #                    #                                         #                    #                    #                    #   
   #                    #                    #                                         #                    #                    #                    #   
   #                    #                    #                                         #                    #                    #                    #   
##########################################################################################################################################################
   #                    #                    #                                         #                    #                    #                    #   
   #                    #                    #                                         #                    #                    #                    #   
   #                    #                    #                                         #                    #                    #                    #   