################
#@             #
#              #
######### ######
#              #
#### ###########
#     #        #
#              #
#     #        #
#     #        #
#     #        #
#     #        #
### ############
# #          # #
#    #    #    #
################