################
#@#   #    # # #
# #   #    # # #
# #   #    # # #
# #   #      # #
#     #    # # #
# #   #    # # #
# #        #   #
#### ###########
#  #      #    #
#  #        # ##
#  #      # #  #
#         # #  #
###### #### #  #
#         # #  #
################