################
#@             #
#              #
############## #
#              #
###### #########
# #  #         #
# #  #         #
# #  #         #
# #  #         #
# #  #         #
# #  #         #
# #  #         #
#              #
# #  #         #
################