################
#@ # # #       #
#  # # #    #  #
#  #   #### ####
#  # # #       #
#  # # #       #
#  # # ####### #
#  # # #       #
#  # # #       #
#  # #         #
#  # # ###### ##
#  # # #  #    #
#    # #  # #  #
#  # # #  # ## #
#  # # #    #  #
################