################
#@             #
#              #
##### ##########
#        #  #  #
####### ##  #  #
#              #
#        #  #  #
##### ##########
#              #
##### ##########
#              #
#              #
### ############
#              #
################