   #                    #                    #                                         #                                                              #   
   #                    #                    #                                         #                                                              #   
   #                    #                    #                                         #                                                              #   
##########################################################################################################################################################
   #                    #                    #                                         #                                                              #   
   #                    #                    #                                         #                                                              #   
   #                    #                    #                                         #                                                              #   
   #                    #                    #                                         #                                                              #   
   #                    #                    #                                         #                                                              #   
   #                    #                    #                                         #                                                              #   
   #      @             #                    #                                         #                                                              #   
   #                    #                    #                                         #                                                              #   
   #                    #                    #                                         #                                                              #   
   #                    #                    #                                         #                                                              #   
   #                                                              #                                         #                    #                    #   
   #                                                              #                                         #                    #                    #   
   #                                                              #                                         #                    #                    #   
   #                                                              #                                         #                    #                    #   
   #                                                              #                                         #                    #                    #   
   #                                                              #                                         #                    #                    #   
   #                                                              #                                         #                    #                    #   
   #                    #                    #                    #                    #                    #                    #                    #   
   #                    #                    #                    #                    #                    #                    #                    #   
   #                    #                    #                    #                    #                    #                    #                    #   
############################       #####################       ##############       ############################       ###################################
   #                    #                    #                    #                    #                    #                    #                    #   
   #                    #                    #                    #                    #                    #                    #                    #   
   #                    #                    #                    #                    #                    #                    #                    #   
   #                    #                    #                    #                    #                    #                    #                    #   
   #                    #                    #                    #                    #                    #                    #                    #   
   #                    #                    #                    #                    #                    #                    #                    #   
   #                    #                    #                    #                    #                    #                    #                    #   
   #                    #                    #                    #                    #                    #                    #                    #   
   #                    #                    #                    #                    #                    #                    #                    #   
   #                    #                    #                    #                    #                    #                    #                    #   
   #                                         #                    #                    #                                                              #   
   #                                         #                    #                    #                                                              #   
   #                                         #                    #                    #                                                              #   
   #                                         #                    #                    #                                                              #   
   #                                         #                    #                    #                                                              #   
   #                                         #                    #                    #                                                              #   
   #                                         #                    #                    #                                                              #   
   #                    #                    #                    #                    #                    #                    #                    #   
   #                    #                    #                    #                    #                    #                    #                    #   
   #                    #                    #                    #                    #                    #                    #                    #   
############################       ###################################       ##############       ##########################################          #   
   #                    #                    #                    #                    #                    #                    #                    #   
   #                    #                    #                    #                    #                    #                    #                    #   
   #                    #                    #                    #                    #                    #                    #                    #   
   #                    #                    #                    #                    #                    #                    #                    #   
   #                    #                    #                    #                    #                    #                    #                    #   
   #                    #                    #                    #                    #                    #                    #                    #   
   #                    #                    #                    #                    #                    #                    #                    #   
   #                    #                    #                    #                    #                    #                    #                    #   
   #                    #                    #                    #                    #                    #                    #                    #   
   #                    #                    #                    #                    #                    #                    #                    #   
   #                                                              #                    #                                         #                    #   
   #                                                              #                    #                                         #                    #   
   #                                                              #                    #                                         #                    #   
   #                                                              #                    #                                         #                    #   
   #                                                              #                    #                                         #                    #   
   #                                                              #                    #                                         #                    #   
   #                                                              #                    #                                         #                    #   
   #                    #                    #                    #                    #                    #                    #                    #   
   #                    #                    #                    #                    #                    #                    #                    #   
   #                    #                    #                    #                    #                    #                    #                    #   
############################       ##############       ####################################################################################          #   
   #                    #                    #                    #                    #                    #                    #                    #   
   #                    #                    #                    #                    #                    #                    #                    #   
   #                    #                    #                    #                    #                    #                    #                    #   
   #                    #                    #                                         #                    #                                         #   
   #                    #                    #                                         #                    #                                         #   
   #                    #                    #                                         #                    #                                         #   
   #                    #                    #                                         #                    #                                         #   
   #                    #                    #                                         #                    #                                         #   
   #                    #                    #                                         #                    #                                         #   
   #                    #                    #                                         #                    #                                         #   
   #                    #                    #                    #                                         #                    #                    #   
   #                    #                    #                    #                                         #                    #                    #   
   #                    #                    #                    #                                         #                    #                    #   
   #                    #                    #                    #                                         #                    #                    #   
   #                    #                    #                    #                                         #                    #                    #   
   #                    #                    #                    #                                         #                    #                    #   
   #                    #                    #                    #                                         #                    #                    #   
   #                    #                    #                    #                                         #                    #                    #   
   #                    #                    #                    #                                         #                    #                    #   
   #                    #                    #                    #                                         #                    #                    #   
##############          #          ###################################       ###################################       ###################################
   #                    #                    #                    #                                         #                    #                    #   
   #                    #                    #                    #                                         #                    #                    #   
   #                    #                    #                    #                                         #                    #                    #   
   #                    #                                         #                                         #                    #                    #   
   #                    #                                         #                                         #                    #                    #   
   #                    #                                         #                                         #                    #                    #   
   #                    #                                         #                                         #                    #                    #   
   #                    #                                         #                                         #                    #                    #   
   #                    #                                         #                                         #                    #                    #   
   #                    #                                         #                                         #                    #                    #   
   #                                         #                    #                    #                    #                    #                    #   
   #                                         #                    #                    #                    #                    #                    #   
   #                                         #                    #                    #                    #                    #                    #   
   #                                         #                    #                    #                    #                    #                    #   
   #                                         #                    #                    #                    #                    #                    #   
   #                                         #                    #                    #                    #                    #                    #   
   #                                         #                    #                    #                    #                    #                    #   
   #                    #                    #                    #                    #                    #                    #                    #   
   #                    #                    #                    #                    #                    #                    #                    #   
   #                    #                    #                    #                    #                    #                    #                    #   
   #          ##############       #####################       #################################################       #####################          #   
   #                    #                    #                    #                    #                    #                    #                    #   
   #                    #                    #                    #                    #                    #                    #                    #   
   #                    #                    #                    #                    #                    #                    #                    #   
   #                    #                    #                                                              #                                         #   
   #                    #                    #                                                              #                                         #   
   #                    #                    #                                                              #                                         #   
   #                    #                    #                                                              #                                         #   
   #                    #                    #                                                              #                                         #   
   #                    #                    #                                                              #                                         #   
   #                    #                    #                                                              #                                         #   
   #                    #                    #                    #                    #                    #                    #                    #   
   #                    #                    #                    #                    #                    #                    #                    #   
   #                    #                    #                    #                    #                    #                    #                    #   
   #                    #                    #                    #                    #                    #                    #                    #   
   #                    #                    #                    #                    #                    #                    #                    #   
   #                    #                    #                    #                    #                    #                    #                    #   
   #                    #                    #                    #                    #                    #                    #                    #   
   #                    #                    #                    #                    #                    #                    #                    #   
   #                    #                    #                    #                    #                    #                    #                    #   
   #                    #                    #                    #                    #                    #                    #                    #   
##############       ##############          #          #####################          #          #####################       ##############          #   
   #                    #                    #                    #                    #                    #                    #                    #   
   #                    #                    #                    #                    #                    #                    #                    #   
   #                    #                    #                    #                    #                    #                    #                    #   
   #                    #                    #                    #                    #                    #                    #                    #   
   #                    #                    #                    #                    #                    #                    #                    #   
   #                    #                    #                    #                    #                    #                    #                    #   
   #                    #                    #                    #                    #                    #                    #                    #   
   #                    #                    #                    #                    #                    #                    #                    #   
   #                    #                    #                    #                    #                    #                    #                    #   
   #                    #                    #                    #                    #                    #                    #                    #   
   #                    #                    #                    #                    #                    #                    #                    #   
   #                    #                    #                    #                    #                    #                    #                    #   
   #                    #                    #                    #                    #                    #                    #                    #   
   #                    #                    #                    #                    #                    #                    #                    #   
   #                    #                    #                    #                    #                    #                    #                    #   
   #                    #                    #                    #                    #                    #                    #                    #   
   #                    #                    #                    #                    #                    #                    #                    #   
   #                    #                    #                    #                    #                    #                    #                    #   
   #                    #                    #                    #                    #                    #                    #                    #   
   #                    #                    #                    #                    #                    #                    #                    #   
##########################################################################################################################################################
   #                    #                    #                    #                    #                    #                    #                    #   
   #                    #                    #                    #                    #                    #                    #                    #   
   #                    #                    #                    #                    #                    #                    #                    #   