################
#@        #    #
#         # #  #
# ######### ## #
#         # #  #
###### #### #  #
# #       # ####
# #       #  # #
# #       #    #
# #       # ####
# #            #
#         ### ##
# #       #    #
# ## ######    #
# #       #    #
################