################
#@      # #  # #
#  #    # #  # #
#  #    # #  # #
#  #    #      #
#  #      #  # #
# ####### #  # #
#    #  # #  # #
#       # #  # #
#    #  # #  # #
#    #  #### ###
###### ##  #   #
#       #      #
##### ###### ###
#       #      #
################