################
#@ #  # #      #
#  #  # ##### ##
#  #  # #      #
#  #  # #### ###
#  #  # # #    #
#  #  # # #    #
#  #  # # #    #
#     # # #    #
#  #  # # #    #
#  #  # # #    #
#  #  # # #    #
#### ##        #
#  #    ### ####
#     # #      #
################