################
#@#        #   #
# #        #   #
# #        #   #
#          #   #
# #        #   #
# #            #
#### ###########
#              #
#### ###########
#      #       #
#    #         #
########### ####
#       #      #
#            # #
################