   #                    #                                         #                                         #                    #                    #   
   #                    #                                         #                                         #                    #                    #   
   #                    #                                         #                                         #                    #                    #   
##########################################################################################################################################################
   #                    #                                         #                                         #                    #                    #   
   #                    #                                         #                                         #                    #                    #   
   #                    #                                         #                                         #                    #                    #   
   #                    #                                         #                                         #                    #                    #   
   #                    #                                         #                                         #                    #                    #   
   #                    #                                         #                                         #                    #                    #   
   #      @             #                                         #                                         #                    #                    #   
   #                    #                                         #                                         #                    #                    #   
   #                    #                                         #                                         #                    #                    #   
   #                    #                                         #                                         #                    #                    #   
   #                    #                    #                    #                    #                                                              #   
   #                    #                    #                    #                    #                                                              #   
   #                    #                    #                    #                    #                                                              #   
   #                    #                    #                    #                    #                                                              #   
   #                    #                    #                    #                    #                                                              #   
   #                    #                    #                    #                    #                                                              #   
   #                    #                    #                    #                    #                                                              #   
   #                    #                    #                    #                    #                    #                                         #   
   #                    #                    #                    #                    #                    #                                         #   
   #                    #                    #                    #                    #                    #                                         #   
##############       ##############       ########################################################          #          ###################################
   #                    #                    #                    #                    #                    #                                         #   
   #                    #                    #                    #                    #                    #                                         #   
   #                    #                    #                    #                    #                    #                                         #   
   #                    #                    #                    #                                         #                                         #   
   #                    #                    #                    #                                         #                                         #   
   #                    #                    #                    #                                         #                                         #   
   #                    #                    #                    #                                         #                                         #   
   #                    #                    #                    #                                         #                                         #   
   #                    #                    #                    #                                         #                                         #   
   #                    #                    #                    #                                         #                                         #   
   #                                                                                   #                    #                    #                    #   
   #                                                                                   #                    #                    #                    #   
   #                                                                                   #                    #                    #                    #   
   #                                                                                   #                    #                    #                    #   
   #                                                                                   #                    #                    #                    #   
   #                                                                                   #                    #                    #                    #   
   #                                                                                   #                    #                    #                    #   
   #                    #                    #                    #                    #                    #                    #                    #   
   #                    #                    #                    #                    #                    #                    #                    #   
   #                    #                    #                    #                    #                    #                    #                    #   
###################################       ###################################       ##############       ##############       ############################
   #                    #                    #                    #                    #                    #                    #                    #   
   #                    #                    #                    #                    #                    #                    #                    #   
   #                    #                    #                    #                    #                    #                    #                    #   
   #                    #                    #                    #                    #                    #                    #                    #   
   #                    #                    #                    #                    #                    #                    #                    #   
   #                    #                    #                    #                    #                    #                    #                    #   
   #                    #                    #                    #                    #                    #                    #                    #   
   #                    #                    #                    #                    #                    #                    #                    #   
   #                    #                    #                    #                    #                    #                    #                    #   
   #                    #                    #                    #                    #                    #                    #                    #   
   #                    #                    #                                         #                    #                    #                    #   
   #                    #                    #                                         #                    #                    #                    #   
   #                    #                    #                                         #                    #                    #                    #   
   #                    #                    #                                         #                    #                    #                    #   
   #                    #                    #                                         #                    #                    #                    #   
   #                    #                    #                                         #                    #                    #                    #   
   #                    #                    #                                         #                    #                    #                    #   
   #                    #                    #                    #                    #                    #                    #                    #   
   #                    #                    #                    #                    #                    #                    #                    #   
   #                    #                    #                    #                    #                    #                    #                    #   
   #          ########################################################       ###############################################################          #   
   #                    #                    #                    #                    #                    #                    #                    #   
   #                    #                    #                    #                    #                    #                    #                    #   
   #                    #                    #                    #                    #                    #                    #                    #   
   #                                                              #                                         #                                         #   
   #                                                              #                                         #                                         #   
   #                                                              #                                         #                                         #   
   #                                                              #                                         #                                         #   
   #                                                              #                                         #                                         #   
   #                                                              #                                         #                                         #   
   #                                                              #                                         #                                         #   
   #                    #                    #                                         #                                         #                    #   
   #                    #                    #                                         #                                         #                    #   
   #                    #                    #                                         #                                         #                    #   
   #                    #                    #                                         #                                         #                    #   
   #                    #                    #                                         #                                         #                    #   
   #                    #                    #                                         #                                         #                    #   
   #                    #                    #                                         #                                         #                    #   
   #                    #                    #                    #                    #                    #                    #                    #   
   #                    #                    #                    #                    #                    #                    #                    #   
   #                    #                    #                    #                    #                    #                    #                    #   
##############       ############################       ##############       ###############################################################          #   
   #                    #                    #                    #                    #                    #                    #                    #   
   #                    #                    #                    #                    #                    #                    #                    #   
   #                    #                    #                    #                    #                    #                    #                    #   
   #                    #                    #                    #                    #                    #                                         #   
   #                    #                    #                    #                    #                    #                                         #   
   #                    #                    #                    #                    #                    #                                         #   
   #                    #                    #                    #                    #                    #                                         #   
   #                    #                    #                    #                    #                    #                                         #   
   #                    #                    #                    #                    #                    #                                         #   
   #                    #                    #                    #                    #                    #                                         #   
   #                    #                                         #                                         #                    #                    #   
   #                    #                                         #                                         #                    #                    #   
   #                    #                                         #                                         #                    #                    #   
   #                    #                                         #                                         #                    #                    #   
   #                    #                                         #                                         #                    #                    #   
   #                    #                                         #                                         #                    #                    #   
   #                    #                                         #                                         #                    #                    #   
   #                    #                    #                    #                    #                    #                    #                    #   
   #                    #                    #                    #                    #                    #                    #                    #   
   #                    #                    #                    #                    #                    #                    #                    #   
##############       ##############       ##############       ###################################          #          ###################################
   #                    #                    #                    #                    #                    #                    #                    #   
   #                    #                    #                    #                    #                    #                    #                    #   
   #                    #                    #                    #                    #                    #                    #                    #   
   #                    #                    #                    #                    #                    #                    #                    #   
   #                    #                    #                    #                    #                    #                    #                    #   
   #                    #                    #                    #                    #                    #                    #                    #   
   #                    #                    #                    #                    #                    #                    #                    #   
   #                    #                    #                    #                    #                    #                    #                    #   
   #                    #                    #                    #                    #                    #                    #                    #   
   #                    #                    #                    #                    #                    #                    #                    #   
   #                    #                    #                                         #                    #                                         #   
   #                    #                    #                                         #                    #                                         #   
   #                    #                    #                                         #                    #                                         #   
   #                    #                    #                                         #                    #                                         #   
   #                    #                    #                                         #                    #                                         #   
   #                    #                    #                                         #                    #                                         #   
   #                    #                    #                                         #                    #                                         #   
   #                    #                    #                    #                    #                    #                    #                    #   
   #                    #                    #                    #                    #                    #                    #                    #   
   #                    #                    #                    #                    #                    #                    #                    #   
###################################       ######################################################################       ##############       ##############
   #                    #                    #                    #                    #                    #                    #                    #   
   #                    #                    #                    #                    #                    #                    #                    #   
   #                    #                    #                    #                    #                    #                    #                    #   
   #                    #                    #                    #                    #                                         #                    #   
   #                    #                    #                    #                    #                                         #                    #   
   #                    #                    #                    #                    #                                         #                    #   
   #                    #                    #                    #                    #                                         #                    #   
   #                    #                    #                    #                    #                                         #                    #   
   #                    #                    #                    #                    #                                         #                    #   
   #                    #                    #                    #                    #                                         #                    #   
   #                                                              #                                         #                    #                    #   
   #                                                              #                                         #                    #                    #   
   #                                                              #                                         #                    #                    #   
   #                                                              #                                         #                    #                    #   
   #                                                              #                                         #                    #                    #   
   #                                                              #                                         #                    #                    #   
   #                                                              #                                         #                    #                    #   
   #                                                              #                                         #                    #                    #   
   #                                                              #                                         #                    #                    #   
   #                                                              #                                         #                    #                    #   
##########################################################################################################################################################
   #                                                              #                                         #                    #                    #   
   #                                                              #                                         #                    #                    #   
   #                                                              #                                         #                    #                    #   