################
#@             #
## #############
#              #
##### ##########
#              #
#              #
# ##############
#              #
#              #
########### ####
#              #
## #############
#   #          #
#              #
################