   #                                         #                    #                    #                    #                    #                    #   
   #                                         #                    #                    #                    #                    #                    #   
   #                                         #                    #                    #                    #                    #                    #   
##########################################################################################################################################################
   #                                         #                    #                    #                    #                    #                    #   
   #                                         #                    #                    #                    #                    #                    #   
   #                                         #                    #                    #                    #                    #                    #   
   #                                         #                    #                    #                    #                    #                    #   
   #                                         #                    #                    #                    #                    #                    #   
   #                                         #                    #                    #                    #                    #                    #   
   #      @                                  #                    #                    #                    #                    #                    #   
   #                                         #                    #                    #                    #                    #                    #   
   #                                         #                    #                    #                    #                    #                    #   
   #                                         #                    #                    #                    #                    #                    #   
   #                    #                                                              #                    #                    #                    #   
   #                    #                                                              #                    #                    #                    #   
   #                    #                                                              #                    #                    #                    #   
   #                    #                                                              #                    #                    #                    #   
   #                    #                                                              #                    #                    #                    #   
   #                    #                                                              #                    #                    #                    #   
   #                    #                                                              #                    #                    #                    #   
   #                    #                    #                    #                    #                    #                    #                    #   
   #                    #                    #                    #                    #                    #                    #                    #   
   #                    #                    #                    #                    #                    #                    #                    #   
   #          ##############       ########################################################       #####################          #          ##############
   #                    #                    #                    #                    #                    #                    #                    #   
   #                    #                    #                    #                    #                    #                    #                    #   
   #                    #                    #                    #                    #                    #                    #                    #   
   #                    #                    #                    #                    #                    #                    #                    #   
   #                    #                    #                    #                    #                    #                    #                    #   
   #                    #                    #                    #                    #                    #                    #                    #   
   #                    #                    #                    #                    #                    #                    #                    #   
   #                    #                    #                    #                    #                    #                    #                    #   
   #                    #                    #                    #                    #                    #                    #                    #   
   #                    #                    #                    #                    #                    #                    #                    #   
   #                    #                    #                    #                                                              #                    #   
   #                    #                    #                    #                                                              #                    #   
   #                    #                    #                    #                                                              #                    #   
   #                    #                    #                    #                                                              #                    #   
   #                    #                    #                    #                                                              #                    #   
   #                    #                    #                    #                                                              #                    #   
   #                    #                    #                    #                                                              #                    #   
   #                    #                    #                    #                                                              #                    #   
   #                    #                    #                    #                                                              #                    #   
   #                    #                    #                    #                                                              #                    #   
##############       ############################       ##############       ########################################################       ##############
   #                    #                    #                    #                                                              #                    #   
   #                    #                    #                    #                                                              #                    #   
   #                    #                    #                    #                                                              #                    #   
   #                    #                    #                    #                                                                                   #   
   #                    #                    #                    #                                                                                   #   
   #                    #                    #                    #                                                                                   #   
   #                    #                    #                    #                                                                                   #   
   #                    #                    #                    #                                                                                   #   
   #                    #                    #                    #                                                                                   #   
   #                    #                    #                    #                                                                                   #   
   #                                                                                   #                    #                    #                    #   
   #                                                                                   #                    #                    #                    #   
   #                                                                                   #                    #                    #                    #   
   #                                                                                   #                    #                    #                    #   
   #                                                                                   #                    #                    #                    #   
   #                                                                                   #                    #                    #                    #   
   #                                                                                   #                    #                    #                    #   
   #                    #                    #                    #                    #                    #                    #                    #   
   #                    #                    #                    #                    #                    #                    #                    #   
   #                    #                    #                    #                    #                    #                    #                    #   
##############          #          ###################################       #####################       ##############       ############################
   #                    #                    #                    #                    #                    #                    #                    #   
   #                    #                    #                    #                    #                    #                    #                    #   
   #                    #                    #                    #                    #                    #                    #                    #   
   #                    #                    #                    #                    #                    #                                         #   
   #                    #                    #                    #                    #                    #                                         #   
   #                    #                    #                    #                    #                    #                                         #   
   #                    #                    #                    #                    #                    #                                         #   
   #                    #                    #                    #                    #                    #                                         #   
   #                    #                    #                    #                    #                    #                                         #   
   #                    #                    #                    #                    #                    #                                         #   
   #                    #                                         #                    #                    #                    #                    #   
   #                    #                                         #                    #                    #                    #                    #   
   #                    #                                         #                    #                    #                    #                    #   
   #                    #                                         #                    #                    #                    #                    #   
   #                    #                                         #                    #                    #                    #                    #   
   #                    #                                         #                    #                    #                    #                    #   
   #                    #                                         #                    #                    #                    #                    #   
   #                    #                    #                    #                    #                    #                    #                    #   
   #                    #                    #                    #                    #                    #                    #                    #   
   #                    #                    #                    #                    #                    #                    #                    #   
   #          ##############       ##############       ##############       #####################       ###################################          #   
   #                    #                    #                    #                    #                    #                    #                    #   
   #                    #                    #                    #                    #                    #                    #                    #   
   #                    #                    #                    #                    #                    #                    #                    #   
   #                    #                    #                    #                    #                                         #                    #   
   #                    #                    #                    #                    #                                         #                    #   
   #                    #                    #                    #                    #                                         #                    #   
   #                    #                    #                    #                    #                                         #                    #   
   #                    #                    #                    #                    #                                         #                    #   
   #                    #                    #                    #                    #                                         #                    #   
   #                    #                    #                    #                    #                                         #                    #   
   #                    #                    #                    #                    #                    #                    #                    #   
   #                    #                    #                    #                    #                    #                    #                    #   
   #                    #                    #                    #                    #                    #                    #                    #   
   #                    #                    #                    #                    #                    #                    #                    #   
   #                    #                    #                    #                    #                    #                    #                    #   
   #                    #                    #                    #                    #                    #                    #                    #   
   #                    #                    #                    #                    #                    #                    #                    #   
   #                    #                    #                    #                    #                    #                    #                    #   
   #                    #                    #                    #                    #                    #                    #                    #   
   #                    #                    #                    #                    #                    #                    #                    #   
   #          ##########################################       ############################       ########################################################
   #                    #                    #                    #                    #                    #                    #                    #   
   #                    #                    #                    #                    #                    #                    #                    #   
   #                    #                    #                    #                    #                    #                    #                    #   
   #                                         #                                         #                    #                    #                    #   
   #                                         #                                         #                    #                    #                    #   
   #                                         #                                         #                    #                    #                    #   
   #                                         #                                         #                    #                    #                    #   
   #                                         #                                         #                    #                    #                    #   
   #                                         #                                         #                    #                    #                    #   
   #                                         #                                         #                    #                    #                    #   
   #                    #                    #                    #                    #                                                              #   
   #                    #                    #                    #                    #                                                              #   
   #                    #                    #                    #                    #                                                              #   
   #                    #                    #                    #                    #                                                              #   
   #                    #                    #                    #                    #                                                              #   
   #                    #                    #                    #                    #                                                              #   
   #                    #                    #                    #                    #                                                              #   
   #                    #                    #                    #                    #                                                              #   
   #                    #                    #                    #                    #                                                              #   
   #                    #                    #                    #                    #                                                              #   
##############       ############################       ##############       ##############       ########################################################
   #                    #                    #                    #                    #                                                              #   
   #                    #                    #                    #                    #                                                              #   
   #                    #                    #                    #                    #                                                              #   
   #                    #                    #                    #                    #                                                              #   
   #                    #                    #                    #                    #                                                              #   
   #                    #                    #                    #                    #                                                              #   
   #                    #                    #                    #                    #                                                              #   
   #                    #                    #                    #                    #                                                              #   
   #                    #                    #                    #                    #                                                              #   
   #                    #                    #                    #                    #                                                              #   
   #                                         #                    #                    #                    #                    #                    #   
   #                                         #                    #                    #                    #                    #                    #   
   #                                         #                    #                    #                    #                    #                    #   
   #                                         #                    #                    #                    #                    #                    #   
   #                                         #                    #                    #                    #                    #                    #   
   #                                         #                    #                    #                    #                    #                    #   
   #                                         #                    #                    #                    #                    #                    #   
   #                                         #                    #                    #                    #                    #                    #   
   #                                         #                    #                    #                    #                    #                    #   
   #                                         #                    #                    #                    #                    #                    #   
##########################################################################################################################################################
   #                                         #                    #                    #                    #                    #                    #   
   #                                         #                    #                    #                    #                    #                    #   
   #                                         #                    #                    #                    #                    #                    #   