   #                    #                                                                                   #                    #                    #   
   #                    #                                                                                   #                    #                    #   
   #                    #                                                                                   #                    #                    #   
##########################################################################################################################################################
   #                    #                                                                                   #                    #                    #   
   #                    #                                                                                   #                    #                    #   
   #                    #                                                                                   #                    #                    #   
   #                    #                                                                                   #                    #                    #   
   #                    #                                                                                   #                    #                    #   
   #                    #                                                                                   #                    #                    #   
   #      @             #                                                                                   #                    #                    #   
   #                    #                                                                                   #                    #                    #   
   #                    #                                                                                   #                    #                    #   
   #                    #                                                                                   #                    #                    #   
   #                                         #                    #                    #                    #                    #                    #   
   #                                         #                    #                    #                    #                    #                    #   
   #                                         #                    #                    #                    #                    #                    #   
   #                                         #                    #                    #                    #                    #                    #   
   #                                         #                    #                    #                    #                    #                    #   
   #                                         #                    #                    #                    #                    #                    #   
   #                                         #                    #                    #                    #                    #                    #   
   #                    #                    #                    #                    #                    #                    #                    #   
   #                    #                    #                    #                    #                    #                    #                    #   
   #                    #                    #                    #                    #                    #                    #                    #   
   #          #####################       ######################################################################       #####################          #   
   #                    #                    #                    #                    #                    #                    #                    #   
   #                    #                    #                    #                    #                    #                    #                    #   
   #                    #                    #                    #                    #                    #                    #                    #   
   #                    #                    #                    #                                         #                    #                    #   
   #                    #                    #                    #                                         #                    #                    #   
   #                    #                    #                    #                                         #                    #                    #   
   #                    #                    #                    #                                         #                    #                    #   
   #                    #                    #                    #                                         #                    #                    #   
   #                    #                    #                    #                                         #                    #                    #   
   #                    #                    #                    #                                         #                    #                    #   
   #                    #                                                              #                    #                    #                    #   
   #                    #                                                              #                    #                    #                    #   
   #                    #                                                              #                    #                    #                    #   
   #                    #                                                              #                    #                    #                    #   
   #                    #                                                              #                    #                    #                    #   
   #                    #                                                              #                    #                    #                    #   
   #                    #                                                              #                    #                    #                    #   
   #                    #                    #                    #                    #                    #                    #                    #   
   #                    #                    #                    #                    #                    #                    #                    #   
   #                    #                    #                    #                    #                    #                    #                    #   
############################       ###################################       ###################################       ##############       ##############
   #                    #                    #                    #                    #                    #                    #                    #   
   #                    #                    #                    #                    #                    #                    #                    #   
   #                    #                    #                    #                    #                    #                    #                    #   
   #                    #                    #                    #                    #                    #                                         #   
   #                    #                    #                    #                    #                    #                                         #   
   #                    #                    #                    #                    #                    #                                         #   
   #                    #                    #                    #                    #                    #                                         #   
   #                    #                    #                    #                    #                    #                                         #   
   #                    #                    #                    #                    #                    #                                         #   
   #                    #                    #                    #                    #                    #                                         #   
   #                    #                    #                    #                                                              #                    #   
   #                    #                    #                    #                                                              #                    #   
   #                    #                    #                    #                                                              #                    #   
   #                    #                    #                    #                                                              #                    #   
   #                    #                    #                    #                                                              #                    #   
   #                    #                    #                    #                                                              #                    #   
   #                    #                    #                    #                                                              #                    #   
   #                    #                    #                    #                    #                                         #                    #   
   #                    #                    #                    #                    #                                         #                    #   
   #                    #                    #                    #                    #                                         #                    #   
##############          #          #####################       ##############       ######################################################################
   #                    #                    #                    #                    #                                         #                    #   
   #                    #                    #                    #                    #                                         #                    #   
   #                    #                    #                    #                    #                                         #                    #   
   #                    #                    #                    #                    #                                         #                    #   
   #                    #                    #                    #                    #                                         #                    #   
   #                    #                    #                    #                    #                                         #                    #   
   #                    #                    #                    #                    #                                         #                    #   
   #                    #                    #                    #                    #                                         #                    #   
   #                    #                    #                    #                    #                                         #                    #   
   #                    #                    #                    #                    #                                         #                    #   
   #                                         #                                                              #                                         #   
   #                                         #                                                              #                                         #   
   #                                         #                                                              #                                         #   
   #                                         #                                                              #                                         #   
   #                                         #                                                              #                                         #   
   #                                         #                                                              #                                         #   
   #                                         #                                                              #                                         #   
   #                    #                    #                    #                    #                    #                    #                    #   
   #                    #                    #                    #                    #                    #                    #                    #   
   #                    #                    #                    #                    #                    #                    #                    #   
##############       ########################################################       ##############          #          ###################################
   #                    #                    #                    #                    #                    #                    #                    #   
   #                    #                    #                    #                    #                    #                    #                    #   
   #                    #                    #                    #                    #                    #                    #                    #   
   #                    #                    #                    #                    #                    #                    #                    #   
   #                    #                    #                    #                    #                    #                    #                    #   
   #                    #                    #                    #                    #                    #                    #                    #   
   #                    #                    #                    #                    #                    #                    #                    #   
   #                    #                    #                    #                    #                    #                    #                    #   
   #                    #                    #                    #                    #                    #                    #                    #   
   #                    #                    #                    #                    #                    #                    #                    #   
   #                                         #                                         #                    #                                         #   
   #                                         #                                         #                    #                                         #   
   #                                         #                                         #                    #                                         #   
   #                                         #                                         #                    #                                         #   
   #                                         #                                         #                    #                                         #   
   #                                         #                                         #                    #                                         #   
   #                                         #                                         #                    #                                         #   
   #                    #                    #                    #                    #                    #                    #                    #   
   #                    #                    #                    #                    #                    #                    #                    #   
   #                    #                    #                    #                    #                    #                    #                    #   
##############       ##############       ###################################       ########################################################          #   
   #                    #                    #                    #                    #                    #                    #                    #   
   #                    #                    #                    #                    #                    #                    #                    #   
   #                    #                    #                    #                    #                    #                    #                    #   
   #                    #                    #                    #                                         #                    #                    #   
   #                    #                    #                    #                                         #                    #                    #   
   #                    #                    #                    #                                         #                    #                    #   
   #                    #                    #                    #                                         #                    #                    #   
   #                    #                    #                    #                                         #                    #                    #   
   #                    #                    #                    #                                         #                    #                    #   
   #                    #                    #                    #                                         #                    #                    #   
   #                    #                                         #                    #                                         #                    #   
   #                    #                                         #                    #                                         #                    #   
   #                    #                                         #                    #                                         #                    #   
   #                    #                                         #                    #                                         #                    #   
   #                    #                                         #                    #                                         #                    #   
   #                    #                                         #                    #                                         #                    #   
   #                    #                                         #                    #                                         #                    #   
   #                    #                    #                    #                    #                    #                    #                    #   
   #                    #                    #                    #                    #                    #                    #                    #   
   #                    #                    #                    #                    #                    #                    #                    #   
##############       ########################################################       ##############       ###################################          #   
   #                    #                    #                    #                    #                    #                    #                    #   
   #                    #                    #                    #                    #                    #                    #                    #   
   #                    #                    #                    #                    #                    #                    #                    #   
   #                                         #                    #                    #                    #                    #                    #   
   #                                         #                    #                    #                    #                    #                    #   
   #                                         #                    #                    #                    #                    #                    #   
   #                                         #                    #                    #                    #                    #                    #   
   #                                         #                    #                    #                    #                    #                    #   
   #                                         #                    #                    #                    #                    #                    #   
   #                                         #                    #                    #                    #                    #                    #   
   #                    #                    #                                         #                                         #                    #   
   #                    #                    #                                         #                                         #                    #   
   #                    #                    #                                         #                                         #                    #   
   #                    #                    #                                         #                                         #                    #   
   #                    #                    #                                         #                                         #                    #   
   #                    #                    #                                         #                                         #                    #   
   #                    #                    #                                         #                                         #                    #   
   #                    #                    #                                         #                                         #                    #   
   #                    #                    #                                         #                                         #                    #   
   #                    #                    #                                         #                                         #                    #   
##########################################################################################################################################################
   #                    #                    #                                         #                                         #                    #   
   #                    #                    #                                         #                                         #                    #   
   #                    #                    #                                         #                                         #                    #   