################
#@ # # #  # #  #
# ## # #  # #  #
#  # # #  # #  #
#  #   #  # #  #
#  # # #  # #  #
#  # # #  # #  #
#  # # #  # #  #
## # # #  #    #
#  # #      #  #
#    # #  # #  #
#  # # #  # #  #
# ## # #### #  #
#  # #    # #  #
#  # #    # #  #
################