   #                    #                    #                                                                                   #                    #   
   #                    #                    #                                                                                   #                    #   
   #                    #                    #                                                                                   #                    #   
##########################################################################################################################################################
   #                    #                    #                                                                                   #                    #   
   #                    #                    #                                                                                   #                    #   
   #                    #                    #                                                                                   #                    #   
   #                    #                    #                                                                                   #                    #   
   #                    #                    #                                                                                   #                    #   
   #                    #                    #                                                                                   #                    #   
   #      @             #                    #                                                                                   #                    #   
   #                    #                    #                                                                                   #                    #   
   #                    #                    #                                                                                   #                    #   
   #                    #                    #                                                                                   #                    #   
   #                                                              #                    #                    #                                         #   
   #                                                              #                    #                    #                                         #   
   #                                                              #                    #                    #                                         #   
   #                                                              #                    #                    #                                         #   
   #                                                              #                    #                    #                                         #   
   #                                                              #                    #                    #                                         #   
   #                                                              #                    #                    #                                         #   
   #                    #                    #                    #                    #                    #                    #                    #   
   #                    #                    #                    #                    #                    #                    #                    #   
   #                    #                    #                    #                    #                    #                    #                    #   
##############       ############################       #####################       ##############          #          #####################          #   
   #                    #                    #                    #                    #                    #                    #                    #   
   #                    #                    #                    #                    #                    #                    #                    #   
   #                    #                    #                    #                    #                    #                    #                    #   
   #                    #                    #                    #                    #                    #                    #                    #   
   #                    #                    #                    #                    #                    #                    #                    #   
   #                    #                    #                    #                    #                    #                    #                    #   
   #                    #                    #                    #                    #                    #                    #                    #   
   #                    #                    #                    #                    #                    #                    #                    #   
   #                    #                    #                    #                    #                    #                    #                    #   
   #                    #                    #                    #                    #                    #                    #                    #   
   #                    #                                         #                    #                    #                    #                    #   
   #                    #                                         #                    #                    #                    #                    #   
   #                    #                                         #                    #                    #                    #                    #   
   #                    #                                         #                    #                    #                    #                    #   
   #                    #                                         #                    #                    #                    #                    #   
   #                    #                                         #                    #                    #                    #                    #   
   #                    #                                         #                    #                    #                    #                    #   
   #                    #                    #                    #                    #                    #                    #                    #   
   #                    #                    #                    #                    #                    #                    #                    #   
   #                    #                    #                    #                    #                    #                    #                    #   
##############       ################################################################################################################       ##############
   #                    #                    #                    #                    #                    #                    #                    #   
   #                    #                    #                    #                    #                    #                    #                    #   
   #                    #                    #                    #                    #                    #                    #                    #   
   #                                         #                    #                    #                    #                    #                    #   
   #                                         #                    #                    #                    #                    #                    #   
   #                                         #                    #                    #                    #                    #                    #   
   #                                         #                    #                    #                    #                    #                    #   
   #                                         #                    #                    #                    #                    #                    #   
   #                                         #                    #                    #                    #                    #                    #   
   #                                         #                    #                    #                    #                    #                    #   
   #                    #                                                                                   #                                         #   
   #                    #                                                                                   #                                         #   
   #                    #                                                                                   #                                         #   
   #                    #                                                                                   #                                         #   
   #                    #                                                                                   #                                         #   
   #                    #                                                                                   #                                         #   
   #                    #                                                                                   #                                         #   
   #                    #                    #                    #                    #                    #                    #                    #   
   #                    #                    #                    #                    #                    #                    #                    #   
   #                    #                    #                    #                    #                    #                    #                    #   
############################       #####################       ###########################################################################################
   #                    #                    #                    #                    #                    #                    #                    #   
   #                    #                    #                    #                    #                    #                    #                    #   
   #                    #                    #                    #                    #                    #                    #                    #   
   #                                         #                    #                    #                                         #                    #   
   #                                         #                    #                    #                                         #                    #   
   #                                         #                    #                    #                                         #                    #   
   #                                         #                    #                    #                                         #                    #   
   #                                         #                    #                    #                                         #                    #   
   #                                         #                    #                    #                                         #                    #   
   #                                         #                    #                    #                                         #                    #   
   #                    #                    #                                                              #                                         #   
   #                    #                    #                                                              #                                         #   
   #                    #                    #                                                              #                                         #   
   #                    #                    #                                                              #                                         #   
   #                    #                    #                                                              #                                         #   
   #                    #                    #                                                              #                                         #   
   #                    #                    #                                                              #                                         #   
   #                    #                    #                    #                    #                    #                    #                    #   
   #                    #                    #                    #                    #                    #                    #                    #   
   #                    #                    #                    #                    #                    #                    #                    #   
   #          ###################################       ########################################################       #####################          #   
   #                    #                    #                    #                    #                    #                    #                    #   
   #                    #                    #                    #                    #                    #                    #                    #   
   #                    #                    #                    #                    #                    #                    #                    #   
   #                    #                    #                    #                    #                    #                    #                    #   
   #                    #                    #                    #                    #                    #                    #                    #   
   #                    #                    #                    #                    #                    #                    #                    #   
   #                    #                    #                    #                    #                    #                    #                    #   
   #                    #                    #                    #                    #                    #                    #                    #   
   #                    #                    #                    #                    #                    #                    #                    #   
   #                    #                    #                    #                    #                    #                    #                    #   
   #                                         #                                         #                                         #                    #   
   #                                         #                                         #                                         #                    #   
   #                                         #                                         #                                         #                    #   
   #                                         #                                         #                                         #                    #   
   #                                         #                                         #                                         #                    #   
   #                                         #                                         #                                         #                    #   
   #                                         #                                         #                                         #                    #   
   #                    #                    #                    #                    #                    #                    #                    #   
   #                    #                    #                    #                    #                    #                    #                    #   
   #                    #                    #                    #                    #                    #                    #                    #   
   #          ###################################       ##################################################################################################
   #                    #                    #                    #                    #                    #                    #                    #   
   #                    #                    #                    #                    #                    #                    #                    #   
   #                    #                    #                    #                    #                    #                    #                    #   
   #                    #                    #                    #                    #                    #                    #                    #   
   #                    #                    #                    #                    #                    #                    #                    #   
   #                    #                    #                    #                    #                    #                    #                    #   
   #                    #                    #                    #                    #                    #                    #                    #   
   #                    #                    #                    #                    #                    #                    #                    #   
   #                    #                    #                    #                    #                    #                    #                    #   
   #                    #                    #                    #                    #                    #                    #                    #   
   #                                         #                                                                                                        #   
   #                                         #                                                                                                        #   
   #                                         #                                                                                                        #   
   #                                         #                                                                                                        #   
   #                                         #                                                                                                        #   
   #                                         #                                                                                                        #   
   #                                         #                                                                                                        #   
   #                    #                    #                    #                    #                    #                    #                    #   
   #                    #                    #                    #                    #                    #                    #                    #   
   #                    #                    #                    #                    #                    #                    #                    #   
##############       ###################################       ###################################       #################################################
   #                    #                    #                    #                    #                    #                    #                    #   
   #                    #                    #                    #                    #                    #                    #                    #   
   #                    #                    #                    #                    #                    #                    #                    #   
   #                    #                    #                    #                    #                    #                    #                    #   
   #                    #                    #                    #                    #                    #                    #                    #   
   #                    #                    #                    #                    #                    #                    #                    #   
   #                    #                    #                    #                    #                    #                    #                    #   
   #                    #                    #                    #                    #                    #                    #                    #   
   #                    #                    #                    #                    #                    #                    #                    #   
   #                    #                    #                    #                    #                    #                    #                    #   
   #                    #                                                              #                                                              #   
   #                    #                                                              #                                                              #   
   #                    #                                                              #                                                              #   
   #                    #                                                              #                                                              #   
   #                    #                                                              #                                                              #   
   #                    #                                                              #                                                              #   
   #                    #                                                              #                                                              #   
   #                    #                                                              #                                                              #   
   #                    #                                                              #                                                              #   
   #                    #                                                              #                                                              #   
##########################################################################################################################################################
   #                    #                                                              #                                                              #   
   #                    #                                                              #                                                              #   
   #                    #                                                              #                                                              #   