################
#@  # #  #  #  #
#   # #  #  #  #
## ## #  #  #  #
#   # #  #     #
#   # #  ## ####
#   # #  #   # #
#   # #  #   # #
#   # #  #   # #
#   # #      # #
#   # #  #   # #
#   # #  #   # #
#   #    #     #
### # #  #   # #
#     #  #   # #
################