################
#@#          # #
# #            #
# ######## #####
# #            #
#              #
# #            #
# # ############
# #   # #      #
# #   # ## #####
# #   # #      #
# #   # #      #
# #   # #      #
# #            #
# #   # #      #
################