################
#@#      #     #
# #      ##### #
# #      #     #
# #      #     #
# #      # #####
# ###### #     #
# #      #### ##
# ##### ##     #
# #  #   # #   #
# #  #   # #   #
# #  #   # #   #
# #  #     #   #
# #  #   # #   #
#        # #   #
################