################
#@ #  #  # #   #
#  ## #  #     #
#  #  #  # #   #
#  # ##    #   #
#  #  ## # #   #
#     #  # #   #
#  #  #  # #   #
#  #     # #   #
#  #  #  # ## ##
#  #  ## # #   #
#  #  #  # #   #
#  #  ## # #   #
#  ## #  # #   #
#  #  #  # #   #
################