################
#@   #    # #  #
#    #    # ## #
#         #    #
######## ## #  #
#           #  #
#         # #  #
############# ##
#   #   #      #
#   #   #  #   #
#   #   #  #   #
#       #### ###
####### #    # #
#              #
#       #    # #
################