################
#@ # #         #
#    #         #
#  # ##### #####
## ###  #   #  #
#    ## #   #  #
#    #  #   #  #
#    #  #      #
#    #  #   #  #
#    #  #   #  #
# ####  #   #  #
#    #  #   #  #
#       #   #  #
# ####  #   #  #
#    #      #  #
################