################
#@     #     # #
#            # #
### ####       #
#      #     # #
########## #####
#              #
###### #########
#              #
#              #
######## #######
#        #     #
#              #
#        #     #
#        #     #
################