################
#@             #
#       #      #
####### ########
#            # #
#              #
#            # #
#            # #
#            # #
##### ##########
#  #      #    #
#            # #
####### ########
#              #
#              #
################