################
#@#   #    #   #
# #   #    #   #
# #   #### #   #
# #            #
# ### #    # ###
# #   #    #   #
# ### #    #   #
#   # #    #   #
# #   #    #   #
# # # #    #   #
# # # #    #   #
# # # #    #   #
# # # ####### ##
# # # #        #
################