################
#@ #        #  #
#  #        # ##
#  #### #####  #
#  #        ## #
#           #  #
#  #        #  #
#  #        #  #
## #           #
#  #        #  #
#  #        #  #
#  #        #  #
#  #        #  #
#  ## #######  #
#  #        #  #
################