################
#@             #
############## #
#              #
######### ######
#              #
#### ###########
#              #
############# ##
#          #   #
#              #
### ########   #
#          #   #
######## #######
#              #
################