################
#@             #
############## #
# #      #     #
#        #     #
# #      #     #
# #      #     #
# #      ##### #
# #            #
# #      #     #
####### ########
#    #         #
# #     #      #
### ####### ####
#    #         #
################