################
#@#  #      #  #
# #         #  #
# #  #      ## #
# #  #      #  #
# #  #      ## #
# ###### ####  #
#              #
# #         #  #
# #         #  #
# #         #  #
# ## ########  #
# #         #  #
# #         #  #
# #         #  #
################