################
#@     # # # # #
# ## ### # # # #
# #    # #   # #
# #    # # # # #
# #    # # # # #
# #    # # # # #
#### ### # # # #
#      # # # # #
#      # # # # #
##### ## # # # #
#  #   # # # # #
#        # # # #
#  #   #   #   #
#  #   # # # # #
################