################
#@   # #  #  # #
#    # #  #  # #
#    # #  #  # #
#    # #     # #
#    # #  #    #
#    #    #  # #
#    # #  #  # #
#    # #  #  # #
#    # #  #  # #
#    # #  #  # #
#      #  #  # #
# ############ #
#         #  # #
#            # #
################