################
#@             #
#### ###########
#          #   #
#              #
######## ##### #
#          #   #
############## #
#       #      #
#              #
# ##############
#              #
#   #          #
#   #          #
#   #          #
################