################
#@# #  #       #
# # #  #       #
# # #          #
#   #  #       #
# # ###### #####
# # #          #
# # #          #
# # #          #
# # ## #########
# # #          #
# # # ##########
# # #          #
# #            #
# # #          #
################