################
#@             #
############# ##
#              #
########## #####
#              #
#              #
############# ##
#              #
#### ###########
#              #
#              #
########## #####
#            # #
#              #
################