################
#@# #  #   #   #
# # #      ### #
# # #  #   #   #
# #    #       #
#   #  #   #   #
# ###  #   #   #
#   #  #   #   #
##### ##########
#   # #  # # # #
#   # #  # #   #
#   # #  #   # #
#   #      # # #
#     #  # # # #
#   # #  # # # #
################