################
#@             #
#              #
###### #########
#              #
######## #######
# # #          #
# # #          #
# # #          #
# # ######### ##
# #            #
# # # ##########
# # #          #
#   ####### ####
# # #          #
################