################
#@# # #        #
# # # #     #  #
# # # # ########
# # # #     #  #
# # # #     #  #
# # #       #  #
# # # #     #  #
# # # #     #  #
# # # #     #  #
# #   ##### #  #
# ### #        #
# #   #     #  #
#     #     #  #
# #   #     #  #
################