################
#@#   #     #  #
#   #    #     #
# ##############
#              #
##### ##########
#              #
############## #
#              #
############ ###
#              #
#            # #
#            # #
#### ######### #
#            # #
################