################
#@       #   # #
### ######   # #
#        #   # #
## #######   # #
#        ### # #
####### ##     #
#        #   # #
#        #   # #
#        #   # #
####### ### ####
#              #
##### ####     #
#        ##### #
#        #     #
################