################
#@           # #
#   #        # #
#   #        # #
#   #        # #
#   #        # #
#   #        # #
### ########## #
#            # #
#            # #
########### ## #
#              #
### ########## #
#            # #
#            # #
################