################
#@ #           #
#  #           #
#  ##### #######
#  #           #
#  #           #
#  ######### ###
#  #           #
#              #
#  #           #
####### ########
#              #
########### ####
#     #   #    #
#              #
################